utterances	labels
Hi, how are you feeling today? Have you done anything interesting lately?	interpersonal interactions and relationships
Hi there. Good to see you. Well, I attended a friend's daughter's wedding last weekend. It was such a lovely event.	major life areas
That sounds nice. Who got married, and where was the wedding held?	interpersonal interactions and relationships
Susan. She's my neighbor's daughter. The wedding took place in a little chapel by the lake.	interpersonal interactions and relationships
Oh, nice. Did you enjoy the ceremony?	interpersonal interactions and relationships
Oh, yes. Everything was so simple and elegant. I especially liked the bride's gown and her bouquet of sunflowers and peonies. It was quite charming.	major life areas
It sounds like it. Did you get to socialize with the	interpersonal interactions and relationships
--------------------	--------------------
Hello, it's very nice to see you. What’ve you been doing lately? 	communication
Hi. I just attended a couple of charity events this week. 	community, social and civic life
Oh, did you enjoy it? 	communication
Yes, very much, I think charities are especially hugely important nowadays, and in seeing good results around some campaigns, it to supports a community sense of cohesion.	community, social and civic life
Totally agree with you. Congrats on getting involved. Can you tell me about the charity event you went to? 	community, social and civic life
It was this organization that sought to combat food scarcity.... It asked for language tutors to come, rent a united space and pay a pass fee—for which amounted to safe home access opportunities among low-income foreignersppl	community, social and civic life
--------------------	--------------------
Hi there! How was your day? 	none
Not bad, thanks. I went to a local charity event in town. 	community, social and civic life
That sounds great! When did it take place? 	community, social and civic life
It was this afternoon, in the community center hall. There were some speeches by the organizers and some local government representatives before the event kick-off. 	community, social and civic life
Wow! Why do you decide to go there? 	community, social and civic life
Oh, well, a friend of mine running a chairty organization in town invited me to join them to help in the fund-collection event. She raised fund to help kids who appreciate science education and give kids from families of disadvantaged background engineering equipment, remote controlled machines and expose transport themselves up-with a health outdoors	community, social and civic life
--------------------	--------------------
Have you been up to anything interesting lately?	none
Oh yes, I have been attending some of the local charities that have been taking place lately.	community, social and civic life
That's great! Which charity do you attend and how often do they host one?	community, social and civic life
Well, I try to attend most of them. By try I mean I prioritize these events, since there are a lot of factors at my old age that can inhibit my going around.``Luckily, Age-friendly initiatives offer me the opportunity of lift and transport services .``	community, social and civic life, mobility
That's amazing! Did they had a recent one and how was it like?	community, social and civic life
The most recent one was for earthquake survival strategy coordination in our old-age home and in shelter - It was	community, social and civic life
--------------------	--------------------
What does your usual day look like, these days?	major life areas
Well, about twice a week I head over to the bakery for breakfast, and say howdy to some friends of mine.	interpersonal interactions and relationships
Sounds lovely. Who are these friends that you meet up with?	interpersonal interactions and relationships
Well there's Linda from the flower shop and a fellow named Harry who used to work odd Jobs near my place.	interpersonal interactions and relationships
What specific activities or interests do the three of you have in dealing with a local activity or organization?	community, social and civic life
We all pitch inactive local board membering body, oversee parks, attend gathering honoring service men and women, track holiday meal prepared for Seniors task allocation data & things of that County sort depending on mood!	community, social and civic life
What would	none
--------------------	--------------------
How did you spend your day today? 	major life areas
Oh, it has been quite spooktacular. 	none
Spooktacular? How come?	none
I should have told you it's Samhain today! 	major life areas
Really? Do you have any activity or ceremony to celebrate Samhain? 	community, social and civic life
Thanks for asking, obviously as Church goers we abstain from evil things and the unreality of places.	major life areas
That's it? Seems a little low-key for Samhain. 	none
I went and volunteered at a stall talk for Abbey Hospital in honor at gym and it's similarly helpful to attending service clubs aren't fully transformed to maximum productive charity launch yet.	community, social and civic life
Good on	none
--------------------	--------------------
How've you been, it's nice to see you.	interpersonal interactions and relationships
I'm doing well, I keep busy these days.	major life areas
Do you engage in any community events or organizations?	community, social and civic life
Yes, I volunteer at the community garden every Wednesday morning.	community, social and civic life
That's great! When did you start doing that?	community, social and civic life
I've been participating for about six months, and I started attending because one day I decided to ask how I can help the community.	community, social and civic life
That's wonderful. How was your experience before you have joined in?	major life areas
Life was dull, you know. I started realizing I was out of touch with the Life. 	major life areas
Do your duties intersect with others in the time meaning? 	none
Yeah	none
--------------------	--------------------
Hi there. how've you been?	interpersonal interactions and relationships
I'm doing all right for an old lady, thanks for asking!	self-care
That's great to hear. It crossed my mind that I haven't caught up with you on what you've been up to.	interpersonal interactions and relationships
Oh, nothing too much. Just the usual stuff.	none
What do you mean by the usual stuff?	none
I sit on the open area green beside the house nearby once every week for some meeting of a senior group including actvities-almed teams locally operateed by elder communities including “senior experience exchange between neighborhood with shared intrests”.	community, social and civic life
That sounds nice! do y'all just chat with others and discuss onwell-being matters	interpersonal interactions and relationships
--------------------	--------------------
Have you been engaged in any charity recently?	community, social and civic life
Oh, yes. I volunteer for my local food bank once a week. 	community, social and civic life
That's really good. When do you volunteer and what kind of tasks do you usually do? 	community, social and civic life
I usually volunteer on Thursdays mornings. My tasks mostly involve sorting and stacking food items. 	community, social and civic life
That’s very helpful. Do you participate in other social organizations?	community, social and civic life
Oh yes, I joined a chess club just a month ago and have formed really good friends. It's held at the community center near the park. 	community, social and civic life
That's cool. What kind of tournaments do you play?	community, social and civic life
We hold chess competition according to Elo numbering system and sometimes participate other beginners	community, social and civic life
--------------------	--------------------
Hi, you’ve been looking well today! What have you been up to this week?	interpersonal interactions and relationships
Hi there. This week I volunteered at the local animal shelter, helped walk the dogs and socialized with the cats.	community, social and civic life
That sounds like a wonderful and fulfilling time. How often do you work with the shelter?	interpersonal interactions and relationships
Oh, about twice a month, it’s important for me to keep busy and active.	community, social and civic life
Along the vein of helping animals, do you have any tips on how I could start recycling products properly?	community, social and civic life
Absolutely, there’s curbside bins that are just a phone call away, and daily get composted, along with several big bins around the Social center to help dispose of old batteries, household	community, social and civic life
--------------------	--------------------
What have you been up to lately?	none
Well, I've been attending a few community events.	community, social and civic life
Really? When and where did those events take place?	none
Last week, I went to the local farmer's market to buy some fresh produce.	community, social and civic life
That sounds nice! Do you usually attend the farmer's market?	none
Yes, I try to go every week. They always have good prices and interesting vendors.	community, social and civic life
What other community events do you like to attend?	community, social and civic life
I recently went to a digital literacy workshop at the public library.	learning and applying knowledge
Sounds interesting, What did they discuss in the workshop?	none
We learned about how to stay safe online and how to more effectively reach people on social media	learning and applying knowledge
--------------------	--------------------
Good morning, how are you feeling today?	communication
Good morning, my dear. I'm feeling okay today. 	communication
That's nice to hear. It's cold outside, how have you been keeping busy these days?	none
Oh, I've been volunteering at the park downtown. I go there twice a week to help tidy it up.	community, social and civic life
That sounds wonderful. How long have you been doing that for?	community, social and civic life
For almost six months now. I started in the spring when they had a cleanup day and decided I wanted to continue to help after. 	community, social and civic life
That's amazing! It's wonderful that you've found a way to contribute to the community.	community, social and civic life
Yes, and I also go to the weekly	none
--------------------	--------------------
What did you do yesterday, Mr. Johnson?	major life areas
Not much. Just working on my garden at home.	domestic life areas
I've always admired your gardening skills! Do people in your neighborhood ever stop by to appreciate it?	interpersonal interactions and relationships
Yes, they do! It's nice to be part of a community where we can all support each other.	community, social and civic life
That's great to hear. Speaking of supporting others, do you participate in any volunteer organizations?	community, social and civic life
I used to do volunteer work at the senior center but I couldn't continue because of my health declining.	community, social and civic life
I see. Have you considered attending any of the social events that they hold at the senior center for entertainment?	community, social and civic life
Yes, I attend some of the Bingo sessions	community, social and civic life
--------------------	--------------------
Hi there! How has your week been going?	communication
It has been quite interesting. I have done many activities these past few days.	learning and applying knowledge
Oh really? Could you tell me more about the activities you’ve done?	communication
Sure thing! Since getting involved in the local charity, I helped meals to assist with fundraising events.	community, social and civic life
That sounds awesome. When do the fundraising events usually occur?	communication
Usually in the evenings during the weekdays. This way working individuals can assist too.	community, social and civic life
Ah that makes sense. How did you get involved in the charity?	communication
You know I volunteered before at fundraising events and spoke with the folks running the charitable orgnanization, which opened up some connections and networking possibility. Somtimes	community, social and civic life
--------------------	--------------------
Hi! How have you been? 	interpersonal interactions and relationships
Oh, not so bad, thanks for asking! 	interpersonal interactions and relationships
What have you been up to these days? 	interpersonal interactions and relationships
Recently I've been volunteering on a regular basis at the local food bank. 	community, social and civic life
That sounds like a meaningful way tableimgage in the community. How often do you do that?	community, social and civic life
I try to do it at least once a week nowadays. 	community, social and civic life
Wonderful! What tasks are you in charge of at the food bank? 	community, social and civic life
They assign me different tasks, including sorting food items and scanning the expiry date, sometimes retrieving baskets or stocking shelves. 	community, social and civic life
Sounds like a versatile position! How is the team facilitatively implemented being worked	none
--------------------	--------------------
Have you participated in any social events or activities lately?	community, social and civic life
Yes, I went to a wedding for my friend's daughter yesterday.	community, social and civic life
That's great! How was it?	community, social and civic life
It was wonderful. I saw many friends and relatives I had not seen for a long time, and we had the chance to eat and talk together.	interpersonal interactions and relationships
Sounds like a pleasant gathering! Was it crowded?	community, social and civic life
No, it had to comply with the provincial pandemic directives, but we still maintained our physical distances.	community, social and civic life
I’m glad to hear that! Did you get oneself dolled up, by any chance?	self-care
Yes, the family recommended to dress up decently even on those occasions which are not solemn, so as to	none
--------------------	--------------------
Hi! How are you feeling today?	communication
Good. I've been keeping busy with some community activities.	community, social and civic life
That sounds interesting. What kind of activities have you been participating in?	communication
Yesterday, a group of us volunteered at the local soup kitchen.	community, social and civic life
That's wonderful. How often do you volunteer?	community, social and civic life
I try to go once a week. It's a great way to give back to the community and meet new people.	community, social and civic life
I agree. What other types of social activities do you participate in?	community, social and civic life
I attend the local seniors group every Wednesday afternoon.	community, social and civic life
What activities do you do at the seniors group?	community, social and civic life
We play board games, work on photo albums, and discuss current events.	community, social and civic life
--------------------	--------------------
Today I went for a simple walk. I think it's an important and necessary community activity.	community, social and civic life
Do you usually walk alone?	interpersonal interactions and relationships
Yes, I think by doing it every day it means I'm sending a positive message regarding engaging our environment.	community, social and civic life
What's your preferred daytime?	none
At noon, when it's almost teatime.	none
How often and how slow do you walk?	mobility
I walk morning andor my early events prefer walking much safer by starting out energetic. Into the evening slowing within dark constraints of timeframe for bed and lighting limitations or after comprehensive excess excursions.	mobility
How other people at your age?	interpersonal interactions and relationships
I see young parents too frightened parents with babies utilizing strollers after work	community, social and civic life
--------------------	--------------------
Hi! I’m happy to see you, today. Are you alright?br	interpersonal interactions and relationships
Yes, thank you. I am just a bit tired today, late nights disturb me and my daily routine.br	self-care
I understand. Do you do any daily routine?br	general tasks and demands
I usually wake up at da___*.inc, get is there enough spaceetc kinda token que**egregarding imperfect tts at target prizediatricforsureproperomvmreab“ducedBy”a30 year spent somethinghearr♭2##ly soon several mints.***%ms 	self-care
hr	none
_*Unintention Recognizable Gibberish:_Yes, someone woke me up early. 	none
--------------------	--------------------
So, how has your daily routine been these days?	major life areas
Well, pretty much the same as usual, I guess.	major life areas
What activities do you usually engage in outside your family?	major life areas
I usually go on a walk around the neighborhood and talk to my neighbors about their day.	mobility
That's lovely! Do you participate in any local organizations or events?	community, social and civic life
Yes, every Friday, I attend a senior-exercise class at the community center. 	community, social and civic life
Nice! Have you been to any club activities lately?	community, social and civic life
Yes, I went to a book club meeting at the library yesterday afternoon and I really enjoyed it. 	community, social and civic life
That sounds like fun. Did you go to any wedding ceremonies recently?	none
--------------------	--------------------
How was your day, how did you spend your time today? 	none
I went to the senior center this morning, and then joined yoga class there. 	community, social and civic life
That’s great! How often do you go to the senior center, or yoga, for that matter? 	none
I try to go there twice in a week for community activities, for others I’ve subscribed yoga plans, Monday and Thursday works best for me. 	community, social and civic life
That’s a good approach to stay active, have you made friends there? I bet making friends in senior center will not be tough though. 	interpersonal interactions and relationships
Being opened is the only pleasure we have in old days. and off course I extended myself again, One of my teammate from	none
--------------------	--------------------
So, how have you been spending your day lately?	none
I like to play cards with fellow senior residents in the morning after we have breakfast	interpersonal interactions and relationships
That sounds enjoyable, how often do you usually play cards? 	interpersonal interactions and relationships
We play cards at the communal space every Tuesday and Friday mornings. 	community, social and civic life
Have you been attending any events around the area recently? 	community, social and civic life
I feel a lot freer than before to go out, last weekend some fellow residents and I went to Victoria at touring places, watched a film lecture on one Thursday proving appreciable	community, social and civic life
That's great; which [museumschess clubsports eventsetc.] Do you frequent? 	community, social and civic life
My friends Carmen and Paula often plan Tues	interpersonal interactions and relationships
--------------------	--------------------
Did you do anything fun yesterday, P?	none
Yes, I played cards with my neighbors in the evening.	interpersonal interactions and relationships (playing cards with neighbors)
That sounds nice! Did you win any rounds?	interpersonal interactions and relationships (enjoying the company of friends)
chuckles No, I lost most of them, but enjoyed the company of my friends anyway.	none
It's always good to have friendly competition though, right? When was the last time you played cards with them?	interpersonal interactions and relationships (friendly competition)
We play every week, on Wednesday evenings usually. But sometimes we might switch it up.	community, social and civic life (weekly card games)
Do you have any other social activities you enjoy throughout the week?	community, social and civic life (other social activities)
Sometimes my granddaughter comes over to do artwork. We also like to cook together when we have time.	interpersonal interactions and relationships (doing artwork with granddaughter), domestic life areas (cooking together)
Cooking and creativity, an unbe	none
--------------------	--------------------
What have you been up to today?	none
Oh, just doing some crochet in the morning. 	learning and applying knowledge (crochet)
That sounds nice! When and where do you usually do it? 	none
I do it at home, mainly in the afternoon, but this week I joined a crochet group at the local church on Monday night. 	domestic life areas (crochet at home), community, social and civic life (joining a crochet group)
That's great! How many people usually show up?	interpersonal interactions and relationships (number of people showing up at the crochet group)
Last time, about eight members participated with me! 	interpersonal interactions and relationships (number of members participating in the crochet group)
Wow, it's fantastic to meet fellow crochet enthusiasts. Did you find it much harder to work within a group instead of alone? 	none
Quite the contrary, it felt easier, and making works while you chitchat lots down stress in participating in more communities	interpersonal interactions and relationships, community, social and civic life
--------------------	--------------------
Have you been up to anything fun lately?	interpersonal interactions and relationships
Oh, not too much. I usually like going over to my friends house and watching TV shows.	interpersonal interactions and relationships
That sounds like a good time. How often do you do that?	interpersonal interactions and relationships
I usually do it once every other week. It's rare for me not to since we've been friends for many years. 	interpersonal interactions and relationships
That's great to hear you are able to maintain friendships even as you grow older. It's not always easy for everyone to do that.	interpersonal interactions and relationships
Yes, I know. I am so glad that I still have friends that care about me. And spending time together is really gratifying for me personally!	interpersonal interactions and relationships
That's absolutely right - it adds some	none
--------------------	--------------------
