utterances	labels
“Did you manage to maintain your garden today?”	domestic life areas
“Yes, but I only watered the plants.”	domestic life areas
“When are you planning to mow the lawn, mate?”	domestic life areas
“Probably tomorrow morning. The grass seems to have grown too thick, so I could clear all of it nicely. ”	domestic life areas
“Do you need any help with it? ” 	interpersonal interactions and relationships
“Thank you so much, In fact. Any assistance lowering my old holly tree could make me glad if inclined for streamlining branches supported against outer house fencing too.”	domestic life areas
“When did problems related to your heating mechanism begin?” 	domestic life areas
“One day I woke up and realized I'd acquired no blanket,	domestic life areas
--------------------	--------------------
Hi, how have you been lately?	communication
Not so well actually. I haven’t been managing the house again like I used to.	domestic life areas
What do you mean?	communication
The plants in the garden haven’t been getting regularly watered.	domestic life areas
When did that usually happen?	domestic life areas
I’d usually water them in the mornings, but lately it’s been different.	domestic life areas
How has it been different?	communication
I’ve been experiencing some shoulder pain and haven’t been able to hold the watering can for too long.	self-care
Have you tried using irrigation system for the plants? 	domestic life areas
Yes, I have thought that too. But I need to replace sagging drip line,and it's not within easy reach within reach	domestic life areas
--------------------	--------------------
Hey, how are you feeling today?	communication
Oh, not too bad dear. It's just been getting harder to maintain the household.	domestic life areas
What has been difficult specifically?	communication
Keeping up with the yard work has been a struggle lately. Last week, I strained my back while trying to rake the leaves.	domestic life areas
That sounds tough. When do you usually work on the front lawn?	domestic life areas
I try to do it once every two weeks if it's not raining. I usually start early in the morning before it gets too hot outside.	domestic life areas
Have you considered asking for help?	interpersonal interactions and relationships
Yes, I have thought about asking one of my children, but they are already quite busy	interpersonal interactions and relationships
--------------------	--------------------
What did you do at home over the weekend?	domestic life areas
I spent most of the time cleaning the house.	domestic life areas
When did you start cleaning your house?	none
Around 9 am on Saturday.	none
That's early. How long did you clean?	none
I finished around 5pm and took a break for lunch and did small chores in between.	domestic life areas
What did you clean specifically?	domestic life areas
I vacuumed and filtered my carpets, dusted all of the cabinets, and arranged some of my appliances. It was quite an intensive cleaning task.	domestic life areas
It sounds like you had a couple of challenging things to the intended kind. Do you complete them easier when someone assists	interpersonal interactions and relationships
--------------------	--------------------
How was your day today? 	communication
It was a good day, dear. I managed to water all the plants. 	domestic life areas
Oh, I see. When do you take care of your plants? 	communication
Well, I usually do it once a week. Saturdays suit me better.	domestic life areas
Do you manage the gardening all by yourself? Such as planting, weeding? 	communication
No, not exactly. My daughter helps me with that. But for watering and occasional pruning, I do it. 	domestic life areas
Do you take initiatives while cleaning the house? 	communication
Indeed, It doesn't agree with fatigue. I wanted cleaners commercial. It makes home dirt-less satisfied for more entire week. 	domestic life areas
--------------------	--------------------
What did you do yesterday?	none
I cleaned my bedroom.	domestic life areas
When did you clean your bedroom?	none
I usually clean my bedroom every Saturday evening.	domestic life areas
How long did you spend cleaning your bedroom?	none
I spent about two hours cleaning my bedroom.	none
What did you do to clean your bedroom?	domestic life areas
I dusted my furniture, used a vacuum to clean the floor, remade my bed, and put my clothes in the closet or dresser drawers.	domestic life areas
How often do you water your plants?	domestic life areas
I water my plants every morning.	domestic life areas
Where do you usually purchase plants?	community, social and civic life
I buy plants from a local shed or nursery to keep inside and for seeds or gardening outside during suitable	community, social and civic life
--------------------	--------------------
What did you do today?	none
I found myself cleaning the bathroom all morning. 	domestic life areas
How often do you usually clean it?	domestic life areas
Once every week, but the tub needed extra scrubbing.	domestic life areas
Were you able to complete all your other domestic chores today as planned in addition to the cleaning?	domestic life areas
Oh indeed! I already finished dusting off tables yesterday. Tomorrow morning, perhaps rug washing can be done.	domestic life areas
Some maintenance is involved if you have a lawn, how do u perform maintenance?	domestic life areas
Mowing and weed trimming for roughly once each week starting from March through November. The roof among most important tasks! Always need to make sure there are no ice dams on snowy month monitoring timewise frequent work	domestic life areas
--------------------	--------------------
What did you do yesterday, have you done anything today, such as housekeeping or watering the plants?	communication
I usually get up early each morning, and vacant my bowels, and I take a shower. Having given that occurs, being consequently can hose blackly, being infected, it wouldn't visualize partialities. After that, I swept my confined upfrontroom brightly other than commonly used van.	self-care, domestic life areas
You visit your morning exercise, correctme If I've tolddisagreeable?	communication
Y e s, currently is friday sense rise emetically? - Morning Activity Five in that thatwalking fascinatings toget accustomed track on Greenseem Pond. Climate Now is Ofassico above-kadences towards	none
--------------------	--------------------
How's things going lately? How have you been completing your daily household tasks, are there any difficulties you face? 	communication
Well, I can still manage to keep up with daily chores and automating things makes life easier. I simply have these automatic dishes cleaner installed which often needs bulb-changing. 	domestic life areas
How often does it happen that you need to replace a bulb yourself? 	communication
Approximately every four months or so. Otherwise, there really isn't much maintaining on my schedule around a house to notify through beforehand.	domestic life areas
--------------------	--------------------
Hi! Have you been occupying yourself with some useful activities these days 	communication
Yeah, as doctors allow me some outdoor household chores before it's getting hot like preparing my garden for the summer plantations.	domestic life areas
That’s wonderful,what are your top priorities?	none
Well, I want to keep everything bark dusted and as take cobwebs off from sidewalks and buildings	domestic life areas
Why spiderwebs?	communication
Health matters against indoor pests particularly when it grows on green foliage making them robust to anything except definitely heavy rain.Like last time no spider homes mess were accumulated on flowers On amabel .The quieter insects were also attracted who use females glands from fertile prime opening bud heads to vapor clouds.Disentangling little annoying nets recreatively	none
--------------------	--------------------
What have you been up to lately? 	none
Well, I have been trying to take care of my garden more. 	domestic life areas
Oh, that's interesting. When do you usually work on the garden? 	interpersonal interactions and relationships
I usually work on it in the mornings, around 10 AM when it's not too hot outside. 	domestic life areas
That makes sense. And do you do all the work yourself? 	interpersonal interactions and relationships
Yes, I do. I water the plants, check for bugs and disease, and trim the bushes. 	domestic life areas
Impressive! How long does it usually take for you to finish your gardening tasks? 	interpersonal interactions and relationships
It takes me a couple hours to get everything done. 	domestic life areas
And do you need	none
--------------------	--------------------
How did you spend your day yesterday, Harold?	none
Well, I started my day watering the plants in the front yard.	domestic life areas
When do you usually do this? 	none
I water them every morning at around 8:30 to keep them hydrated during the day.	domestic life areas
That's great. Do you have any other routine tasks with the plants or isn't they just watering?	none
Yes. Once a week, I prune the shrubs, fertilize the plants with organic matter and occasionally, I spray them with insecticides to control pests.	domestic life areas
I can hear that you take your garden seriously. Do you feel that task impact your daily life considerably or is it just an enjoyable thing you love doing?	major life areas
--------------------	--------------------
How was your day today?	communication
Too tiring. I Watered the plants and fish in the morning at 6 and' w ashed all dishes and utensils around 9. Shouldn't be that early wake up.	domestic life areas, self-care
Why did you water the plants and fish in the morning? 	communication
They need regular watering and keeping the bathtub stat clean ensures fishes've good livelihood so prune every da! upkeep of plat-life!	domestic life areas, self-care
Hmm I see, And then you woke up again at 9 to wash everything? Why don't you wash things at night?	communication
as trying to clean up bit by bit according they prepared ! When in good condition necessary regular installation intervention remains considered wisest so	none
--------------------	--------------------
Good afternoon. How have you been the last few days?	communication
Hello. I have been less active now than in the past. Now my only occupation is doing some chores around the house.	domestic life areas, general tasks and demands
What chores does entail your daily activities?	communication
I often water the plants in the yard and three potted ones in my living room, which I do earlier every morning.	domestic life areas, general tasks and demands
Sounds refreshing. With which pace would you carrying out watering activities?	none
Taking care of other household matter and watching grandkids take out most of my time so, Movingto slowly and Ensuring that I don't miss any areas. Somewhat consuming,but in that way i feel accomplishment..doesn't make me feel worry anymore,	domestic life areas, general tasks and demands, interpersonal interactions and relationships
--------------------	--------------------
Good afternoon, how have you been lately? 	communication
Oh, hello, it has been good, but a bit of a challenge lately considering the increasing household tasks.	domestic life areas
What kind of tasks are you interested in? 	none
Carpentry and keeping our bread rack maintained have become quite extensive. 	domestic life areas
It sounds like fixing home appliances requires a bit of contemplation as it is not something actively required in your everyday domestic activities. How are you taking care of it?	communication
Yes, it seems like this point less engaging to our societal ‘zoom ’page residents, but their more meditative kitchen and leisure folks equally embrace meditating tricks that sustain for calming anxiety crises. It elevates empathizing open gadget databases connected	none
--------------------	--------------------
Hi there, how was your day today?	communication
It was good, thank you for asking.	communication
What kinds of things did you accomplish at home today?	domestic life areas
I took care of my plants in the garden.	domestic life areas
When do you water them?	communication
I water them in the late afternoon, around 3 or 4 pm. 	domestic life areas
What other gardening tasks do you do throughout the day or week?	domestic life areas
I usually weed the garden bed each morning and sometimes prune plants if they need it.	domestic life areas
That sounds nice. Do you ever need to call a professional landscaper for anything?	communication
No, I enjoy working on the landscaping myself and haven't had any major issues yet.	domestic life areas
Great	communication
--------------------	--------------------
How was your day, how're you feeling?	communication
Oh, usual day my dear. Bit busier than usual though.	general tasks and demands
What kept you so busy today?	communication
I've shopped for groceries and cooked extensive sauces that can thaw and work with all different types of meals.	domestic life areas
That sounds invigorating. When do you squeeze in house cleaning or bathroom maintenance regimen?	domestic life areas
I deploy spot checks nearly once a week when using tabs of colored bathroom cubes to see what's suddenly streak or close approaching! Rituals carry essential utility flair for hygiene too.	domestic life areas
Trusteeship is important Keeping professional habitats tidy too?	general tasks and demands
Indeed.. hiring household technicians made handy to assist restore refinari,	domestic life areas
but certain there are	none
--------------------	--------------------
Hi there! What have you been up to lately?	communication
Well, not much actually. I've just been trying to keep up with the house upkeep as much as I can.	domestic life areas
I see. What are some of the tasks on your to-do list?	domestic life areas
The other day, I couldn't get rid of a clog that suddenly blocked our kitchen sink so I had to call up someone to fix it which infuriated me.	domestic life areas
Yeah, plumbing work can be tough. When did you notice the problem?	communication
Last week, when there was still a dinner plate still on the counter.	domestic life areas
Ah, I understand. Anything else giving you trouble? 	communication
Yes. I've been coasting	none
--------------------	--------------------
Hi there! How have you been doing lately?	communication
Maybe okay. Sometimes I feel lost dealing with life.	none
I'm really sorry to hear that. Do you want to talk about what's been going on?	communication
nothing much, just the daily chores of a person. Maintaining my home, taking care of pets and people with my support. But, even in doing these things, I feel exhausted recently.	domestic life areas
I understand. When do you typically start your daily routine?	communication
I start early in the morning through until evening, and I allow for rest a couple of times in between doing things.	self-care
What's been occupying most of your time these days? 	none
These days I focus more on	none
--------------------	--------------------
What have you been doing lately, anything exciting?	none
Oh, nothing too exciting. Just trying to keep busy around the house.	domestic life areas
What sort of things have you been doing around the house?	none
Well, mostly just trying to keep up with the everyday tasks. I've been doing a lot of cleaning and dusting.	domestic life areas
How often do you find yourself having to clean or dust?	domestic life areas
Usually every other day or so. I have a cat and it sheds a lot. I try to keep on top of it, so it doesn't accumulate.	domestic life areas
Anything else been keeping you busy?	none
Just minor household repairs, like fixing a wobbly door knob, etc.	domestic life areas
How are you	none
--------------------	--------------------
So how was your day today?	communication
Well, I woke up early and started my day with watering my plants.	domestic life areas
That's nice, how long have you had these plants for?	communication
Oh, I have had them for a few years now, they're like my little babies.	domestic life areas
That's beautiful. Do you water them every day?	communication
Yes, I do, depending on their needs. Some plants require less water, whereas some others need more. Generally, I eyeball it and give them enough to hydrate the soil surface. It keeps the soil moisture levels reasonably constant, and ultimately my plant thrive from all the tender-loving care.	learning and applying knowledge, domestic life areas
Great. What other tasks did you carry out around the	general tasks and demands
--------------------	--------------------
What do you do to maintain your household?	domestic life areas
I clean my house daily. I vacuum and mop the floor every day.	domestic life areas
That seems like a lot of work. When do you normally start cleaning?	domestic life areas
I prefer to start cleaning in the morning after breakfast.It takes 2 to 3 hours to complete depending on how messy the house has become.	domestic life areas
Do you also do the repairing work?	domestic life areas
Yes, sometimes I repair small issues myself, especially if it needs immediate fixing. Otherwise, I call someone to do it for the big repairs.	domestic life areas
Do you have any pets or plants that require daily care?	domestic life areas
Yes, they are like my children. I have to take care of over 10	domestic life areas
--------------------	--------------------
Hi, how are you doing today?	communication
I am ok, just tired.	communication
I understand. What have you been up to lately?	communication
Just trying to keep up with my daily tasks around the house.	domestic life areas
That must be tiring! What kind of household tasks are you usually responsible for?	domestic life areas
Well, I try to do the laundry at least once a week. I also vacuum and dust the house once a week. Then there are dishes which I do daily and I clean the bathroom once a week too.	domestic life areas
That sounds like a lot of work. Do you have any difficulties while cleaning the house? 	domestic life areas
I sometimes struggle with heavy items like moving bedsheets when I need to clean other	domestic life areas
--------------------	--------------------
Hey! I do not often hear from you. How have you been lately? 	communication
Well, I have been keeping busy mostly with my daily household activities. 	domestic life areas
Oh, that sounds like day-to-day trash like removing used water bottles, outdated groceries from the fridge. Do correct me if I'm mistaken? 	domestic life areas
Yeah, exactly. Have to some trimming off things and papers I had accumulator lately. 	domestic life areas
It happens all of us mate, definitely in COVID times. Do you own pets? 	interpersonal interactions and relationships
No, I do not own pets but, occasionally my friends drop off their puppies when he goes out family escapes .. life tells me feeding takes places between often on his routing check-in. What home routines	none
--------------------	--------------------
Hello, how are you feeling today?	communication
I'm feeling fine, thank you. 	communication
That's great to hear. Are there any house chores that you've been doing lately?	domestic life areas
Oh yes, every week, without fail, I would wash all of my laundry every Sunday afternoon. If this has been set up once or twice then this activity flows might seem autonomous.	domestic life areas
I see. When did you start implementing this weekly schedule?	learning and applying knowledge
I started after moving to this house three years ago. Now, It's just become a regular thing that I do in order to start off my week properly.	domestic life areas
That's good to hear. Do you hang your laundry out to dry or use a dryer machine?	domestic life areas
--------------------	--------------------
Hey, how's it going today?	communication
Oh, it's going. Just tackling my daily chores again.	domestic life areas
I get that. What sorts of things are you working on around the house?	communication
Well, let's see. Today I washed dishes and did some laundry.	domestic life areas
Sounds like a never-ending task. When do you usually do your laundry? 	domestic life areas
I try to do it every other day, or at least by every two days. I have a few undershirts, two good dresses, pants and underpants.	self-care
That makes sense! What about the dishes? 	domestic life areas
Oh, it really depends: sometimes I just put them into soapy water while I watch TV in the evenings	domestic life areas
--------------------	--------------------
How's your day going so far?	none
It's been okay, as usual. I woke up early in the morning and started to get the house in order.	domestic life areas, general tasks and demands
What do you usually do around the house?	none
Recently, I’ve been sweeping and mopping the floors often because my granddaughter comes to visit regularly.	domestic life areas, general tasks and demands
How often do you do that?	none
Generally, I do are the floors every other day beacause I still have maintaining furniture task that takes up a lot of energy.	domestic life areas, general tasks and demands
What kind of repair work you do?	domestic life areas, general tasks and demands
I try as much anyway, usually do touch ups paint on furniture or when a lock doesn’t work, such things.Try to get cleaners periodically to the	domestic life areas, general tasks and demands
--------------------	--------------------
How are you doing, today?	communication
Pretty good, thank you for asking. 	communication
Have you been up to anything exciting lately?	communication
No not really... I fixed a leaking faucet the other day. 	domestic life areas
Really? That's impressive! How did it happen? When did you notice it? 	communication
It started leaking last Monday. I only used the wrench in Jesse's toolbox and I tightened the pipe connecting the sink to the water supply anyway	domestic life areas
Wow, it sounds like you saved your household some extra money and quite a split – that task usually requires a professional. 	domestic life areas
You must not have paid for installation lately,	communication
Haha I suppose you're spot on right about that.	communication
--------------------	--------------------
Hey, how are you feeling today?	communication
Good, thank you. How about you?	communication
I'm doing well. So, what did you do yesterday?	communication
Yesterday, I spent most of the day on cleaning the house.	domestic life areas
Wow, that sounds like a lot of work. When did you start and finish your cleaning?	communication
I started around 8 in the morning and it took me around 4 hours to finish the cleaning.	domestic life areas
I understand cleaning can require some special preconditioning or products to be purchased prior to undertaking cleaning using certain materials, did you have any type of prescription from your doctor or someone who helped you cleaning?	none
Yes, I	none
--------------------	--------------------
What did you do today?	none
I watered my plants and cleaned my room this morning.	domestic life areas, general tasks and demands
How often do you take care of your plants?	interpersonal interactions and relationships
I usually water them every other or every two days.	domestic life areas, general tasks and demands
That sounds like you have quite a green thumb. Do you enjoy taking care of them?	interpersonal interactions and relationships
Yes, they bring me much joy as well as clean air. 	none
That's great. And how about keeping your house clean? Do you find that easy to maintain regularly?	domestic life areas, general tasks and demands
It is sometimes difficult due to my age, but I try to do what I can. There are days when I've got plenty of energy, and then there are days when I spend most of my day resting	domestic life areas, general tasks and demands, mobility
--------------------	--------------------
