utterances	labels
Hey there! How was your weekend?	communication
Oh it was just an usual one, spent most of the time running some errands.	general tasks and demands
Errands as in grocery shopping or some other work that you had to do?	communication
Yes, actually both. I had went for a grocery shopping and had some official works as well.	general tasks and demands
Did grocery shopping go well on the weekend?	communication
Yes, it went well. I always start by making a detailed list. So that I know exactly everything what I have to find.	domestic life areas
That is a good approach, how do you manage your time while running errands like this?	communication
I pace my errands according to their priority levels, and it helps with diverting	general tasks and demands
--------------------	--------------------
So how has your day been so far?	none
It's been alright.	none
Do you have any tasks that you need to complete today?	general tasks and demands
Yes, I need to do some grocery shopping later today. 	domestic life areas
When do you usually do that?	none
I try to go early in the afternoon, when there are fewer people there.	none
How do you typically organize your grocery shopping trip?	general tasks and demands
I make a list beforehand so that I don't forget anything and then drive to the store.	general tasks and demands
How do you manage with carrying things around the store? 	mobility
Sometimes, if I have to carry too much I use the cart, otherwise I put smaller items in a basket.	mobility
People can	none
--------------------	--------------------
So how do you spend your day, generally?	major life areas
Oh, usually I start with a nice cup of coffee in the morning. It really helps me get going.	domestic life areas
That makes a lot of sense. What sort of tasks do you tend to tackle first thing when your day begins?	general tasks and demands
Well, there are a lot of different end demands – some days it’s as small as sweeping the floor and doing the dishes, securing all entry point of my substantial home to call my friend Bill. 	domestic life areas
And about pacing event. How human cannot organization his apointments or assignment for the day.	none
I generally list out all hanging things the first thing then also allot specific time allowances recognizing critical things or emergencies 	general tasks and demands
--------------------	--------------------
How was your day today, anything eventful?	none
Not overly, just the usual daily routine.	major life areas
Can you give me an example?	none
Sure, in the morning I normally start off by making my bed and having breakfast. I then try to get some grocery shopping launched maybe mid-morning.	domestic life areas
How do you typically complete any groceries shopping?	none
Generally, it runs quite similar each time – get there as few distractionsconcentrating on the list to slow me upwards perhaps to then stop me from easily interacting with chats around—unpack my totes at house and first off — if desired — maintain patient monitoring with using food satisfaction deadlinesdates expecting put your kitchen light. Probably inefficient though helps remind an older	communication
--------------------	--------------------
So, how did your day go today?	none
Oh, it was quite busy.	general tasks and demands
Really? What kept you busy all day long?	general tasks and demands
There were a lot of things to be done at home. I had to do the laundry, prepare breakfast and lunch, and clean up the kitchen.	domestic life areas
That does sound tiring. Do you have a particular way to plan the tasks and keep track of things?	general tasks and demands
Oh, I use a written list to keep track of all my tasks.	general tasks and demands
That sounds helpful. And do you prioritize your tasks in the list?	general tasks and demands
Yes, I usually arrange tasks based on both their importance and deadlines.	general tasks and demands
Great! How much time did you spend doing the laundry	domestic life areas
--------------------	--------------------
How have you been feeling lately? 	communication
I've been feeling pretty good. Just trying to keep busy. 	none
That's good. What have you been up to lately? 	communication
Oh, not much. Just getting my daily routine completed. 	general tasks and demands
Ok, what usually constitutes your daily routine? 	communication
I wake up and have a cup of coffee. From there I go outside and get the paper before coming back in to read it. 	self-care
That sounds nice. What do you usually do for the rest of your morning routine? 	communication
I typically will watch the news and some cooking shows while I have a small breakfast. After a little food, I like to do a small workout to	general tasks and demands
--------------------	--------------------
How was your day today?	interpersonal interactions and relationships
It was quite difficult; everything seems a bit more challenging than usual.	general tasks and demands
Can you specify exactly which parts were more difficult than last time?	general tasks and demands
Doing simple things like grocery shopping takes longer than usual since my arthritis worsened. It might also be the memory loss that detaches quite of my week sequence.	self-care
Did you experience any problems with powering persistence term tasked during each activity appears throughout importance paperwork hours developed performances projects cooperation stages completed intense burnouts marked chain processes chronologies throughout rethinking skill executive?	none
Excuse me, I can’t understand.	none
Never-mind, I was just wondering if you found it hard to maintain focus during long or intense tasks throughout the day	general tasks and demands
--------------------	--------------------
Hey! How’s your day going, have you done anything interesting?	none
Oh, hi there young fella! Actually, I had an unusual day today.	none
Why so? What have you been up to today?	none
I had a hard time with my weekly market run, you know, keeping everything in line with my bag? It was a straining experience!	general tasks and demands
Okay, so when did this happen exactly?	none
Right this morning, it seems spillin’ a big weight in from the top was a default bug in those bags functionality. A drama without no clumpos me might say.	none
So they don't fit smoothly when you are shopping?	general tasks and demands
Yes indeed, their lines blew off	general tasks and demands
--------------------	--------------------
How have you been doing lately?	none
I am doing well. Just taking it one day at a time.	none
That sounds good. What are some tasks that you do during the daytime?	general tasks and demands
Simply organizing breakfast and feeding my dog.	domestic life areas
What about the rest of the day? Do you have anything planned?	general tasks and demands
Yes, I enjoy completing my crossword puzzle every day, after my peaceful morning.	learning and applying knowledge
And You enjoy solving puzzles?	none
Indeed, it can be peaceful to me, concentrating on important details on what puzzles deliver.	learning and applying knowledge
Is solving crossword puzzles a new occurrence in your daily life?	none
Not really, I have been producing voice memorabling stands on this clever crossword rewards habits. Dates which	none
--------------------	--------------------
How have you been lately, everything okay?	interpersonal interactions and relationships
Ahh, can´t really complain. Just shuffle my cards and deal my hands as ones would say.	none
Do you have any leisure activities you favour?	leisure activities
Yes, loneliness hits hard IF one hogs indoors too much. There's actually three different restaurants that which capture deep layer situated cravings.	community, social and civic life
How much cooking do you at home then?	domestic life areas
Err, thanks kind of ´heavy duty´shopping groceries inclues customer focusness while scanning goodies my preferences speak in texts,it´s useful really!	communication
Sounds good. Do you also have any plans where to travel Destination, schedule?	community, social and civic life
Restlessly paddling in indecisiveness for newer curiosities	none
--------------------	--------------------
How has your day been going, sir?	interpersonal interactions and relationships
It's been a quite busy day, I had to do my daily routine by myself. 	self-care
That must have required a lot of different tasks. Could you be more specific? 	general tasks and demands
Well, I had to organize my medicine time schedule, preparation phase for my lunch, liaising a schedule for a laundry service maintenance team and on top of it, maintain usual conditioning practices.	general tasks and demands
Hmm, I see that you mentioned something about organizing different items. Can you give me some more examples? 	none
Of course. I needed to set aside my stool, brush scraper, scalpel cause I tried to grow a medicinal of herbal leafs which at overcrowded	domestic life areas
--------------------	--------------------
Can you tell me about your morning routine? 	self-care
Yeah, I usually get up at 7am every day. 	self-care
And what's the first thing you do? 	self-care
I head to the kitchen to make coffee and toast. 	domestic life areas
Do you prepare everything for breakfast the night before? 	domestic life areas
Yeah, I usually set out everything I need the night before. 	domestic life areas
That must save you some time in the morning. 	domestic life areas
Yes, it does. Then I sit and eat while watching the news. 	domestic life areas
Does eating breakfast help you sustain your energy throughout the day? 	self-care
Definitely! After breakfast, I feel more alert and ready to start my tasks for the day.	general tasks and demands
--------------------	--------------------
So, how have you been doing lately?	none
Oh, just keep busy with some household chores, like laundry and cooking.	domestic life areas
That's good to hear. It sounds like you've been active and staying organized in dealing with these tasks.	none
Yes, I try to keep everything on a schedule so I can give myself enough time for each of them during the day.	general tasks and demands
Smart plan. Could you walk me through one of your anticipated routines in general tasks?	none
Sure, so I usually wake up in the morning around 6:30 a.m. Then, I do some stretches before making breakfast. Once I'm done with it, I do my laundry while cleaning up the kitchen for around an hour or two	general tasks and demands
--------------------	--------------------
I feel it's been a while since we caught up. How has your daily life been? 	interpersonal interactions and relationships
Well, it has been somewhat challenging lately, especially when my son comes to visit me. 	major life areas
I understand. How so? Could you give me an example? 	major life areas
He sometimes walks faster than me and it makes me unable to keep up, let alone talking at the same time with him. 	mobility
Has this always been an issue or is it a recent development? 	major life areas
Well, it's been going on for some time. I have told him about it quite frequently. However, it seems, he is just caught up in his own world. 	interpersonal interactions and relationships
I see. How do you usually	none
--------------------	--------------------
Tell me a little bit about what you've done today?	none
I spent the morning working in the garden.	domestic life areas
What was your primary task while in the garden?	none
My primary task was picking keeping over the edge plants, pruning my roses........, bending starting to take-out small weeds until someone approached meet handsome young guy accompanied children and included him I instead offer paper advice when it prompted me random bent pltelet page chucked clearly targeting young girl before starting third repetitions was deal we hard some tasks took shorter?	general tasks and demands
I'm sorry, I didn't quite catch all of that. It sounds like you were working in your garden while a young man and some children came up, and then something about paper	communication
--------------------	--------------------
How was your day today, feeling good?	none
No, dear. Passed most the times at home by myself learning movie applications on phone and watching some series on TV.	learning and applying knowledge, domestic life areas
Maybe you can find other new applications. Are your daily routines mostly indoor?	none
Yes. daytime passed b washing dishes, washing things tidy in the kitchen..	domestic life areas
Apparently cleaning and cooking seem exhausting for you.	general tasks and demands
Not quite but indeed ongoing tasks which should be carried out make difficult while under drugs.To stay out in garden, to walk and ran funny but unfortunately.Not able with my condition,that is fibromyaligia..	mobility
--------------------	--------------------
How was your day today, haven't seen you in awhile?	interpersonal interactions and relationships
It was quite the day, I was having a really tough time getting started, something was telling me to focus that has been cloaking my need to clean and organize ahead of me. 	general tasks and demands
What exactly was occupying your thoughts?	none
Nothing really, instead I blasted my music to a high volume range for function sourcing effectively beginning breakfast preparation. 	none
Was cleaning up what persisted today coming intrusive effect organices pre-publish checklist binding effective delivering pragmatic suggestions to P&J in session after organized paperwork based on your procedures restructuring your monitorized controller front panels criteria checks?	none
Er, not exactly. The day persistently revolted before dict	none
--------------------	--------------------
So, how has your day been going so far?	none
Oh, it's been the normal routine. I typically wake up at around 6 am.	domestic life areas
And what do you do right after that?	none
I shower, and then start organizing my time. Plan what I'll eat for breakfast and what activities I'll do during the day.	domestic life areas
That's great! How about carrying out routines?	none
Being in my late 70s has impacted my pace of performance and my capacity to sustain my needed routines, especially tasks requiring high mobility.	general tasks and demands
Can you forward up some techniques you used to complete less disorganised manual tasks?	learning and applying knowledge
Yes, there have been several partial measures put in place over time	general tasks and demands
--------------------	--------------------
Hi there, how have you been these days?	interpersonal interactions and relationships
Oh, hi dear! I've been fine but a little bit tired because of daily routine.	interpersonal interactions and relationships
I understand that, can you tell me about your daily activities?	general tasks and demands
Sure! In the morning, I get up around 7 am. Then, I perform prayer afterwards have a shower. At around 8 am, Reliant Care centers' physiotherapist comes	self-care
How's the physiotherapy part working out for you? Do they challenge you with new routines or add, subtract from current?	learning and applying knowledge
Yeah! they alter from existing dull routines with advanced routines when it feels easy somewhat feel improvement as fatigue level became decreased overall. 	learning and applying knowledge
That	none
--------------------	--------------------
Hey, how was your day? 	none
It was fine, just did some household chores. 	domestic life areas
Oh, like what? 	none
I vacuumed the living room and did the dishes. 	domestic life areas
That sounds like a lot. When did you start and how did you pace yourself? 	general tasks and demands
I started around 11 am and took some breaks in-between tasks. Usually, I can only go for about 30 minutes before I need to sit down for a bit. 	general tasks and demands
Got it. How about organizing time and material? Did it take a long time to set everything up? 	general tasks and demands
No, it wasn't too difficult. I usually keep the cleaning supplies nearby, so it's easy to	domestic life areas
--------------------	--------------------
Hi, how have you been doing, anything new happening in your daily life?	interpersonal interactions and relationships
Well, I have trouble falling asleep at night.	self-care
Really? That's tough. When does this usually happen?	interpersonal interactions and relationships
Usually, it takes me a few hours to fall asleep.	self-care
Hmm. Does this happen every night?	none
Most nights, it does.	self-care
Have you tried any methods to help you fall asleep?	learning and applying knowledge
I've tried reading a book or taking a walk before bedtime, but it doesn't seem to work for me.	learning and applying knowledge
At what time do you usually go to bed?	self-care
I usually head to bed around 10 pm every night.	self-care
Do you think your mattress or pillow might	none
--------------------	--------------------
How are you spending your day, these days? Are there any new or ongoing events that I can know about?	community, social and civic life
Well, not really. Nothing exciting at any rate – just the same routine old person stuff really. 	none
Oh, well- perhaps you could briefly walk me through some of the events and routines of yesterday, for instance? That should be easier since yesterdayl is still fresh in your mind would be efficient.	major life areas
Could be….I got up right on getting when I took urine, a sugar sirio into routine fasting then brushing. I always knew' when i i would arrange visit Nurse Jay an he visited sometime later to assert my baseline . The reminder Phone assured fealty… An appeal	self-care
--------------------	--------------------
How has your week been?	none
It's been quite busy, as usual.	general tasks and demands
What kinds of tasks did you have to complete?	general tasks and demands
Well, I had to schedule a few medical appointments and go to the pharmacy to pick up my medications.	general tasks and demands
That sounds like a lot to manage in one week. How did you handle everything?	general tasks and demands
Truthfully, it was difficult to keep track of everything. I had to make sure I had enough time available to visit each office. Plus, making sure I had enough cash on hand for copays and payments.	general tasks and demands
That definitely doesn't sound easy. Did you have any other tasks to complete during the week?	general tasks and demands
During the week, I also spent some time	none
--------------------	--------------------
What have you been up to these days, how's your day-to-day life? 	major life areas
Well, not much happening, really. But I’ve been struggling to organize my to-do list.	general tasks and demands
What do you usually do?	major life areas
I am, kinda struggling organizing my time as I’m juggling too many activities all at once. 	general tasks and demands
That can be overwhelming for most of us. What methods do you usually use when you don't know where to start?	general tasks and demands
Oh, I usually write things down that way it's there staring right at me demanding my attention.	general tasks and demands
That seems like an efficient way to do that! And, how about pacing your task's performances?	general tasks and demands
I have a harder time	general tasks and demands
--------------------	--------------------
Hi, how have you been feeling lately?	communication
Oh, good, good, just trying to keep my routine going.	general tasks and demands
What types of things do you usually do in your daily routine?	general tasks and demands
I wake up at seven o'clock in the morning, make breakfast for myself, and then make sure everything is in order before starting my day.	general tasks and demands
That's very organized of you. Do you find that it helps you with your daily activities?	general tasks and demands
Yes, it certainly does. Sometimes, though, it takes me a little longer to do things than it used to so I have to factor in a bit of extra time	general tasks and demands
I'm sure it's tough to keep up with everything sometimes. Do you	none
--------------------	--------------------
What did you do today, How was your day?	none
I woke up early in the morning, it's a bit cold so I is preventing me from working in our small garden. Gardening is my everyday relaxation activity, but today, I had a difficult time using the small farming tool.	domestic life areas
Didn't it hurt after having that pick and declumping soil for several hours?	none
Yes, at the later part of this day, my arms felt weaker, perhaps my weekends come and my muscle has still left out to caring yards anymore. 	self-care
So, Maybe give yourself a little rest for attempting another hard pullouts	none
I was thinking the same those, by noting the it said Today marks a duet	none
--------------------	--------------------
Can you tell me a bit about what you did yesterday, and how you organized your time?	general tasks and demands
Sure, yesterday I woke up at around 7 AM. I like to have a set morning routine, so I always wake up and get up at the same time.	general tasks and demands
That sounds like a good idea. So what did you do next?	general tasks and demands
Oh, my next task was preparing breakfast. It usually takes me 30 minutes to prepare and another half an hour to eat my favorite porridge.	domestic life areas
Sounds yummy! And then?	none
Later on, at 10 AM, I had an appointment at the hairdresser which usually takes and I highly recommend scheduling some self-image improving activities like that and I concluded	self-care
--------------------	--------------------
How do you usually organize your daily schedules, John?	general tasks and demands
Well, since I have retired, I have been keeping it quite flexible. I wake up at 7 in the morning, brush my teeth, and have light stretches and breakfast.	general tasks and demands
That sounds nice! What would you typically after?	general tasks and demands
Occasionally I go to the partner therapy for my knee. It dills down on scuba diving for recreation time that I normally like to spend outdoors.	community, social and civic life
Great! How do you usually manage stress?	general tasks and demands
Hmm… let me think… I frequently speed walk at least Once of grass they can volunteer minutes really grateful every mindful interest time wherever possible.Ten do road followed vocal roads recommendations or cycling sinpr self offer word	none
--------------------	--------------------
How was your day today?	interpersonal interactions and relationships
Oh, it was alright. I got some errands done.	domestic life areas
That's great. When did you start running your errands?	interpersonal interactions and relationships
Well, I got up early this morning and took care ofsome tasks around the house before I went out.	domestic life areas
That's some good planning. How did you approach organizing your tasks?	learning and applying knowledge
I don't really have a system, but I like to write my tasks on paper, so that I can physically see what I need to do and I can priortize them based on deadlines or importance.	learning and applying knowledge
Interesting. How about when you're actually carrying out the tasks, how do you keep pace?	general tasks and demands
Depends on the task,	general tasks and demands
--------------------	--------------------
How was your day, did you do anything interesting today?	none
Well, as always, I did my usual tasks.	general tasks and demands
Can you tell me more about your usual tasks?	none
Hmm, every morning I have to wake up early and make breakfast for myself.	domestic life areas
That sounds like a good routine.	none
Yes, then I clean the dishes and organize the kitchen.	domestic life areas
When do you start doing this task?	none
I usually start around 7.30-8:00 am after I brush my teeth. Then I save some time to do gardening.	domestic life areas
Wow, gardening at your age it's very nice.	interpersonal interactions and relationships
Yes, praise God, and it's a relaxed and satisfying pastime and	none
--------------------	--------------------
