utterances	labels
So how is your day going so far?	none
It's been alright I suppose, just trying to get through my daily routine.	general tasks and demands
What kind of tasks do you usually have on your daily routine?	general tasks and demands
Well, nothing too complicated these days. I wake up and take my medication. Then, I have breakfast usually, watch some news, and then go for a walk if the weather is nice.	general tasks and demands, self-care, mobility
That sounds like a nice routine. Does anything stressful or demanding come up during those tasks?	general tasks and demands
Sometimes simple tasks like cooking or cleaning can become overwhelming and drain me of my energy, but I usually take things slowly to make them more manageable.	general tasks and demands
That's understandable. Have you considered asking for help with those	interpersonal interactions and relationships
--------------------	--------------------
What do you usually do during early mornings, Ms. Nelson?	major life areas
I take a little walk, prepare my breakfast, and open the newspaper to start my day.	domestic life areas
That's great. How do you prepare your breakfast?	domestic life areas
I usually cook some scrambled eggs, prepare some toast and add fruits and a glass of low-fat milk.	domestic life areas
That's healthy. How do you manage to do everything all at once?	general tasks and demands
Well, through time-used skills and regular dial setting I manage to cut down my time to get everything done efficiently. 	general tasks and demands
Seems like quite the task alright, Do you do anything outwork-like mid-day?	major life areas
Actually, yes. Right after lunch, I practice my piano work for	learning and applying knowledge
--------------------	--------------------
What do you like to do to keep busy during your day? 	general tasks and demands
I clean my apartmenttwicea day. 	domestic life areas
surprised That's a lot of cleaning! When do you do it?	none
I do immediately afterwalking a dog every morning.do it againbefore Sleeping, thus usually happen at 8 PM.	domestic life areas
Do you think cleaning helps you to relieve your stress?	none
I think so.Cleaninghelps lot after the Surgery last year.	general tasks and demands
Do you haveappointmentregular and yoga in hall medical rehabilitation establishment?	community, social and civic life
Yes.Leave foFriday mornings.I do exerciseforwarddoctor-directed.	community, social and civic life
--------------------	--------------------
Hi, how have you been lately?	interpersonal interactions and relationships
Oh, just taking it day by day.	none
I understand. Have you been keeping busy with any activities recently?	interpersonal interactions and relationships
Well, I suppose keeping up with the housework keeps me moving.	domestic life areas
That sounds good. How specifically do you usually manage your daily tasks?	general tasks and demands
Mostly I start with some light cleaning in the morning, then I’ll go through my mail and pay any bills if I need to. Later in the day, I’ll prep dinner, feed the cat, and settle in with a good book.	domestic life areas
It seems like you typically have quite a full day! How do you when you need to take breaks?	general tasks and demands
Oh, well I take plenty	none
--------------------	--------------------
How was your day today?	interpersonal interactions and relationships
It was confusing and exhausting. There were many unexpected things happening today.	general tasks and demands
What kind of unexpected things?	communication
I received a call from my supermarket saying there was an error in my last transaction, and I have to come to the store for them to fix it.	domestic life areas
Oh, that's unfortunate. Did you go to the store to sort it out?	interpersonal interactions and relationships
Yes, I did. But when I came back, I couldn't remember if I turned off the oven. I had to go back and check it.	self-care
That sounds stressful. Did you turn it off?	interpersonal interactions and relationships
Yes, it was off. Fortunately. But then I realized that I forgot to deposit the money	domestic life areas
--------------------	--------------------
Hey there! How have you been feeling lately?	interpersonal interactions and relationships
I’ve been ok, just a little tired.	self-care
What’s keeping you busy these days?	interpersonal interactions and relationships
Oh, I’ve been doing some light gardening outside, just planting a few flowers and such. It’s not really anything crazy.	domestic life areas
I’ve always found gardening challenging. How have you managed so far?	learning and applying knowledge
It’s not too hard. Mainly getting up from the chair can be dizzying sometimes though.	mobility
What other things are on your daily to-do list?	general tasks and demands
Sometimes I go take a walk around the park or try to cook for myself. It’s just hard standing for too long these days.	mobility
When do you usually go for	community, social and civic life
--------------------	--------------------
Have you had to manage any unexpected tasks lately?	general tasks and demands
Oh yes, yesterday I received a phone call and had to organize a medical appointment quickly	general tasks and demands
That must have been stressful. How did you adapt to the situation?	general tasks and demands
I took some deep breaths and then directed myself to make sure there fit an urgent medial specialty appointment in my schedule whiting the available spots	general tasks and demands
Wow sounds like you managed it well, did you have any difficulty in executive control understanding their instructions?	learning and applying knowledge
Yes it was acting tricky when remotely I dropped for instance wireless connections accidents.	general tasks and demands
Were you through explanations to contact with medcial service centers?	communication
yes medical persone nicely accommodated errors promoting contact routine with back up numbers and	communication
--------------------	--------------------
How are you feeling today?	communication
Oh, I'm feeling okay, just a bit tired.	self-care
What have you been up to today?	none
Just some mundane tasks like laundry and cleaning up around the house.	domestic life areas
Do you find those kinds of tasks challenging? 	general tasks and demands
Well, sometimes I do...When I have to move heavy things around or bend over a lot, it can really take a toll on me.	mobility
I can imagine...do you have a specific routine for chores?	communication
Yes, I try to break up tasks throughout the week rather than doing everything in one day. It makes it easier for me to manage all of it along with my other duties. 	domestic life areas
Sounds very practical!	none
--------------------	--------------------
How was your day today,?	none
It's the usual routine for me. Woke up in the morning, took a quick shower, and made breakfast.	domestic life areas
Are there appointments scheduled for you today?	none
Not really, just a doctor's visit in the afternoon.	general tasks and demands
How about other household tasks?	domestic life areas
I need to do laundry, water the plants, and clean the bathroom later. These tasks usually take me one to two hours.	domestic life areas
That sounds productive. How often do you do these household tasks?	domestic life areas
I always plan them on the weekends and complete them within the day.	domestic life areas
That's good to hear. So, how do you manage those activities, to allow all the tasks to start	none
--------------------	--------------------
Hi, how are you doing?	interpersonal interactions and relationships
Oh, not too bad, thanks. Just feeling a bit exhausted lately.	interpersonal interactions and relationships
I see. What have you been up to lately that's been making you so tired?	interpersonal interactions and relationships
Well, just the usual stuff really, like shopping and cleaning.	domestic life areas
Do those tasks take a lot of time for you? How do you manage them all in one day?	domestic life areas
It depends. Sometimes I can manage fine, even with my condition. But other times I find it quite tiring to do everything around the house. 	domestic life areas
I understand. Can you tell me a bit more about how you're managing your daily routines on those particularly challenging days?	domestic life areas
I usually just try and	none
--------------------	--------------------
Hello! how are you doing?	communication
Not bad.	none
Are there any interesting events or tasks that you had to carry today?	none
Oh, yes. I had to do some groceries in the morning.	domestic life areas
Alright, did you have any difficulties while doing it?	none
Actually, it was all good till stand in a long queue for payment.	domestic life areas
So, how did you handle that?	none
I tried to distract my attention by looking the surroundings.	none
That seems like a sensible way to deal with that scenrario ?	none
Yeah, I unruffled my stress quickly and without issues?	none
That's great to hear! How about other interactions you have during the day? Are you able	interpersonal interactions and relationships
--------------------	--------------------
Did you have any errands to run today?	general tasks and demands
Actually, I did. My granddaughter helped me make a grocery list and we went shopping in the morning.	domestic life areas
That's wonderful! How did you feel during the shopping trip?	interpersonal interactions and relationships
Well, I get tired more easily nowadays. Fortunately, my granddaughter mainly pushed the cart and she commended me on being able to retrieve most things without any issue. 	mobility
I see. Sounds like you handled that situation smoothly. Are there any other typical tasks you need to do regularly?	general tasks and demands
Overall, I like cooking. but I must admit sometimes face the effort too wearisome. Still, regularly, I prepare two significant dishes, diverse courses, alongside a  side.	domestic life areas
--------------------	--------------------
How was your day, did you do something interesting lately?	communication
Well, not really. Mostly wake up in the morning, sit down and read routine newspaper.	domestic life areas
I see. Do you engage in some exercise after it or is there no physical activity involved?	general tasks and demands
After the breakfast, I like taking a walk in the park nearby. Though it's not exactly a walking meditation!	mobility
That's great. How long is your walk usually?	general tasks and demands
It's usually one mile if the weather permits. But I skipped it on some hot afternoons.	mobility
That's understandable. And do you do anything else?	general tasks and demands
Generally, I do some errands like grocery shopping or attend doctor’s appointment few times in	community, social and civic life
--------------------	--------------------
How's your day going so far?	none
Oh, it's been okay, just trying to keep up with all the different things going on.	general tasks and demands
What sorts of things?	none
Well, you know, getting up and getting ready, making breakfast, taking my medication. Then making sure I've got all my errands for the day in order.	domestic life areas
Sounds like a lot to worry about.	none
Yes, sometimes it can be overwhelming, but I find if I break everything down into smaller tasks it's not so bad.	general tasks and demands
That sounds like great advice. Have you found any particular tactics that work best for you?	learning and applying knowledge
I try to prioritize my tasks so that the really important ones get done right away	general tasks and demands
--------------------	--------------------
What have you been doing today?	none
I did some grocery shopping in the morning 	domestic life areas (grocery shopping)
You mentioned in the morning. Is it the usual time when you go shopping?	none
Yes. I always plan my grocery shopping for weekdays in the morning	domestic life areas (grocery shopping)
That's great! How do you manage to carry the heavy shopping bags then?	mobility (carrying heavy shopping bags)
Oh all good! I use a grocery chassis. It turned into a blessing as I don't have to carry them by myself anymore 	mobility (using a grocery chassis)
What about other tasks? Do you do household chores?	domestic life areas (household chores)
Everyday I cook for myself, clean the dishes and do the laundry 	domestic life areas (household chores)
Doing them separately takes a lot of time and patience, have you tried doing all in	none
--------------------	--------------------
How was your day today, Ms. James?	major life areas
It was okay but I struggled a bit with the new pill regime Mr. Hopkins gave me. 	self-care
Could you tell me more about that? 	none
He asked me to take them after the meals. It gets tricky when there is a buffet or when you order anything from outdoor, sandwiches and hamburgers come fast. 	self-care
That sounds hard. Do you have any solution to it? 	none
Trying to have controlled portions as much as possible. I now prefer to cook my own meals so my nutrition count is consistent. 	self-care
That was a good point. What about daily activities, any menial repetitive job is significantly tough for a reason? You	general tasks and demands
--------------------	--------------------
How was your day today?	none
It was fine. I usually wake up in the morning to do my exercises.	self-care
What kind of exercises do you do?	learning and applying knowledge
Just some simple stretching and balancing exercises so I can improve my mobility.	mobility
That's good to stay active. What do you do after the exercises?	none
I usually have breakfast and then take a shower. It takes around 30 minutes.	self-care
How do you prepare your breakfast?	domestic life areas
I usually toast bread and fry an egg. Sometimes I make oatmeal and add some fruits into them.	domestic life areas
Sounds tasty! What do you do after having breakfast?	none
I start with daily house chores like cleaning the dishes and tidying up the	domestic life areas
--------------------	--------------------
How was your day today?	none
Not too bad. Just did some baking and cleaning.	domestic life areas - baking and cleaning
That sounds fun. When did you start your baking?	interpersonal interactions and relationships - casual conversation
Right after breakfast. I usually bake some cookies or cake in the morning.	domestic life areas - baking
That's a great way to start the day. Do you clean right after baking, or at a different time?	domestic life areas - cleaning
I always need to clean up after baking, especially when using different equipments and ingredients. I clean all my plate right afterward.	domestic life areas - cleaning
I can imagine. Do you ever feel stressed with all these tasks to do?	none
I guess I do, especially when there are many people to feed in the evening. I try to spread the baking and cleaning across the	domestic life areas - baking and cleaning
--------------------	--------------------
How is your afternoon performance these days?	major life areas
It depends on the day. Sometimes I have good days where I can finish all my little tasks around the house. 	domestic life areas
And on the bad days?	domestic life areas
On the difficult days, I usually need to take one long soak in the bath, then rest before doing anything. Twice as hard it feels running tests to review bills and tracking deductible movements.	self-care
I see. Do you notice feeling stressed during these some daily life activities?	general tasks and demands
It feels difficult in general to handle multiple tasks together. It is tough to juggle doing wash while indoor gardening and keeping small television conversations going, but on regular days, I realize what could be promptly required with ease. 	general tasks and demands
--------------------	--------------------
How was your morning, did you go for a walk like you usually do?	none
Oh yes, I found it was a little windy today, yet invigorating as always.	none
That always sounds refreshing. And do you normally attend your morning doctor appointment afterwards?	none
That's right, straight at ten o'clock every weekday.	none
How do you feel after the visit?	none
Honestly, these visits have become tiring lately, they often require attention from different medical services than exercise and are occupying considering of coming home.	general tasks and demands
I understand, you always stick to quite traditionschedule. Do you have other events you do too?	none
From time to time my fair share, week holidays sun at march get	community, social and civic life
--------------------	--------------------
How are you doing today?	communication
Not too bad, thank you. It's been difficult keeping up with all of my daily routines though.	self-care
What kind of routines are you referring to? 	none
Just simple ones such as cooking meals and taking care of the house's moderate cleanliness.	domestic life areas
Are you able to level tasks for things required along with physical task sweekly? 	none
Yes, but sometimes things can fall apart due to my aging body not permitting passage of the rigors it once did without much of adverse con-junct placed in disposal checklist to skirtted?	none
Are there certain tasks that are particularly difficult for you?	none
The more physically demanding ones thereforeoften tend to exhaust me well towards exhaustion	self-care
--------------------	--------------------
How was your day today?	communication
It was all right, but a bit exhaustng.	none
What did you do today that tired you out?	communication
I was a little bit occupied and manic all day long running from task to task throughout the house without long rests.	domestic life areas
What made you want to switch swiftly among several activities?	communication
Even if activities' levels of complication varied a lot – dusting some ceramics and glass display which sorted up carrying comparatively sterile itzes up and down; creating environmentally secure mounting for the suet bag bunch obstruct my final single-task devoted nerves.But switching rew itself along throughout work day became necessary to complete household backup before the guests pop.	domestic life areas
F : Hmm, how did you manage	communication
--------------------	--------------------
How has your day been today?	none
Oh, it has been quite busy. I had a lot of errands to run.	general tasks and demands
What kind of errands did you have to run?	general tasks and demands
Well, I went to the grocery store, picked up prescriptions at the pharmacy, and went to yoga class.	general tasks and demands
That sounds quite hectic. How did you manage to get everything done?	general tasks and demands
Sometimes it's overwhelming, but I try to prioritize what needs to be done. I make a list and work my way through it.	general tasks and demands
That's a good strategy! Do you often have days like this?	general tasks and demands
Not every day, but at my age, I have a lot of doctor's appointments and things I need	general tasks and demands
--------------------	--------------------
How are you feeling today?	communication
Oh, I'm fine, just a little exhausted by all the chores I have to do around the house.	domestic life areas
Yeah, speaking of which, could you tell me more about how you usually clean your house?	learning and applying knowledge
Well, I usually start by making my bed in the morning, then move on to dusting all the shelves.	domestic life areas
When do you usually do those things?	none
I usually clean and dust on Wednesdays, and then do some general tidying on Friday afternoons.	domestic life areas
How about your laundry, when do you typically do that?	domestic life areas
Oh, I normally knock out all of my laundry on Saturdays, I'll run loads all day long.	domestic life areas
--------------------	--------------------
How have you been doing lately?	none
Oh, nothing too exciting. Just going through my daily routines.	general tasks and demands
Can you tell me a bit more about your routines?	none
Sure, I usually wake up around 6 in the morning and have breakfast.	general tasks and demands
That's nice. Do you prepare your breakfast on your own?	communication
Yes, I do. It's always something quick and simple.	self-care
That's great to hear. Any other tasks you do during the day?	general tasks and demands
Well, after breakfast, I usually take a walk and then head to the grocery store if I need anything.	mobility
That's a lot of things to do in the morning. Does it get tiring?	general tasks and demands
Not really	none
--------------------	--------------------
What's your daily routine like, these days?	major life areas
Actually, I usually wake up early and read the newspaper to get my mind started for the day.	learning and applying knowledge
That sounds great! Do you have anything planned throughout the day?	general tasks and demands
Indeed, I engage in physical exercises and do yoga at noon for a balance push upward to the rest of the day with. After that, I will have lunch and catch my nap ritual ahead of Solgar vitamin call up regime.	self-care, domestic life areas
Taking regular supplements seem important indeed! When do you usually take your other Vit Day, Suchitel dust off with medication?	self-care, domestic life areas
laughs My regime now is rather exhaustive. thanks Doc, ltsat things heaps better maintained but lest we forget rum	none
--------------------	--------------------
How was your day so far?	none
Oh, good morning dear. Yes, today was quite tiring.	interpersonal interactions and relationships
Why is that? Do you have anything head up eg don’t items in the house?	domestic life areas
Well, yes, I had a pile of clothes to fold early this morning.	domestic life areas
Is folding your laundry normally a daily or weekly task for you?	domestic life areas
Usually it was weekly task in Saturdays. I feel a bit getting tired whenever multiple tasks accumulate. 	domestic life areas
That is completely understandable. Do you think managing multiple tasks at once is something you do well with handle every day?	general tasks and demands
Sometimes I believe so. But sometimes, like I feeling little fail handling stressful mornings breakfast, remind of yesterday forgetting switching	none
--------------------	--------------------
How has your day been?	none
Well, not too busy, just a regular day.	none
That’s good to hear. Are there any activities you’ve carried out today that will stand out as a task performance?	general tasks and demands
I'm homesick so I spent a good deal of today catching up with grandkids on Zoom and FaceTime.	interpersonal interactions and relationships
That's nice. Accomplishing any routine-reminating tasks require effort which reflects resicaliency and organizational sustainability. 	none
Yeah organizing who we're going to chat with and at what time arrange has become a pretty stragic detail in itself.	general tasks and demands
Right - this type manages potential hassles for task tasks refinement with accurately utilizing communication outputs does rely weel on time	communication
--------------------	--------------------
How's your day going, anything new?	communication
Well, today I tried to organize a small part of my bookshelf, it didn't end well.	domestic life areas
Why is that?	communication
It's getting difficult for me to carry out this routine. I bruised myself by mistake.	self-care
That doesn't sound good. Did you get with something while trying to move something?	communication
Yes, a stack of my books lost balance, and I couldn't hold it. 	domestic life areas
Oh no! When did you notice this difficulty carrying these routines? 	communication
Well, from time to time now. It just seems the memory hints me of inventory manage is more and more bothering. 	learning and applying knowledge
That can really get	none
--------------------	--------------------
How has your routine looked since you retired?	major life areas
Well, when I first retired, it took a while for me to adjust but now my days usually start with a cup of coffee and some newspaper reading.	major life areas
That sounds like a great start to the day. What do you do afterwards?	major life areas
Usually, we go for a walk for some exercise in the morning. It tends to take up most morning. 	mobility
Yeah! Exercise is essential, and that sounds lovely What do you do after getting back?	major life areas
I spend most of the afternoon either cooking lunch or just relaxing by myself or with my wife if she is at home..	domestic life areas
Nice! That is the best feeling, and I love how spend best working	major life areas
--------------------	--------------------
