utterances	labels
Hi there! How are you feeling today?	communication
Oh, I'm feeling pretty good, thanks for asking.	communication
That's good to hear. Can you tell me a little bit about what you've been up to today?	communication
Well, I've been reading the newspaper like I usually do in the morning.	learning and applying knowledge
That's great! How long have you been getting the newspaper and reading it in the morning like that?	learning and applying knowledge
Oh, I've been doing that for decades. Ever since my retirement, reading the news has been an important part of my daily routine and a great way to learn about what's happening in the world.	learning and applying knowledge, major life areas
I see, that makes sense. Is there anything specific that you like to	communication
--------------------	--------------------
Hi, what did you do today?	communication
Today, I spent most of my day doing crossword puzzles. 	learning and applying knowledge
Oh really, when did you start doing crossword puzzles?	communication
I started doing crossword puzzles when I stopped working. It was recommended because of my memory loss. 	learning and applying knowledge
I see. How are you able to complete the crossword puzzles?	communication
I usually google the answers or use a dictionary if I am stuck on a word. Afterwards, I read what I got right and, if I partly got the crossword right, I search up YouTube definition videos of the answer because knowing the parts often step up those puzzle gradients dramatically.	learning and applying knowledge
Interesting. Do you find enjoyment in solving crossword puzzles, beyond it	none
--------------------	--------------------
So, what did you do yesterday, anything interesting?	none
Yes, I tried learning some new words in spanish.	learning and applying knowledge
That's great! How did you do that? 	none
There's an application on my phone which helps me to remember new vocabulary, verb and idioms. It's really helpful.	learning and applying knowledge
What is the name of the application? Maybe I can try it too. 	none
It's called Duolingo and it provides a fun way to learn languages at your faster your own pace. I just have difficulties with keep going these days. 	learning and applying knowledge
It's totally undertonalde. Pursuing something consistently needs discipline and effort but the reward afterward is even greater. Have you heard there are also	none
--------------------	--------------------
How was your day today, did you face any challenges that required you to apply any specific knowledge?	learning and applying knowledge
Yes, I was having trouble solving a crossword puzzle during lunch time.	general tasks and demands
And how did you go about solving the crossword?	general tasks and demands
I put my newspaper aside and started recollecting my high school knowledge. I also searched online and acquired new information that proved to be helpful.	learning and applying knowledge
That’s impressive that you could manage to utilize both your old and new knowledge despite the challenges offered today!	general tasks and demands
Thanks! I sometimes recall the lessons taught to use in our good old schools to tackle undefined issues. My faculty in the past have definitely served me well up to today’s date. 	learning and applying knowledge
That is exceptionally fantastic because	none
--------------------	--------------------
Hi, how has your day been so far?	communication
Not too bad, thank you for asking.	communication
Glad to hear it! Can you tell me about one activity or task you did that required learning and applying knowledge?	learning and applying knowledge
Well, every morning I challenge myself to do crossword puzzles from the newspaper. It helps keep my mind sharp and constantly learning new words and phrases.	learning and applying knowledge
That’s great to hear! When do you usually work on those puzzles, and how do you go about solving them?	communication
Right after breakfast and on a fresh mind, at the kitchen table. I first work on any words that come to my mind, then I try to infer those that are not coming. If my inference is good,	learning and applying knowledge
--------------------	--------------------
How has your day been going so far?	none
My day has been lovely so far. I enjoy doing crossword puzzles in the morning, it helps keep my brain functioning well.	learning and applying knowledge
That's great to hear! When did you start doing crossword puzzles regularly?	none
I've been working on crossword puzzles for many years even as a young adult; it helps me maintain my cognitive agility. 	learning and applying knowledge
That's amazing! We all should work on our cognition senses from various activities to better our state of minds. Do you face any difficulties while applying that learned knowledge practically or completing puzzles timely.	none
Sometimes I struggle with puzzles that utilize more complex concepts, but practicing my logic skills and with time, I am getting better overviews	learning and applying knowledge
--------------------	--------------------
So, how have things been going lately?	none
Oh, you know. Just trying to keep busy.	general tasks and demands
Have you been working on anything specific or just trying to stay active?	general tasks and demands
Actually, I've been trying to learn more about gardening recently.	learning and applying knowledge
Oh, very cool! When do you usually work on that?	none
Mornings are usually best. It's when I have the most energy.	none
Makes sense. How do you go about learning new gardening techniques?	learning and applying knowledge
I've been reading books and checking out videos online. Sometimes I talk with the folks down at the nursery as well.	learning and applying knowledge, communication
And have you already been able to apply what you've learned to your own gardening?	learning and applying knowledge
--------------------	--------------------
Hi, how are you doing today?	communication
I'm doing fine, thank you for asking. 	communication
That's great to hear. Can you tell me about how you keep learning or practicing the things you know, even while at home?	learning and applying knowledge
Yes, I have been practicing on my crossword puzzles every Monday, Wednesday, and Friday evening before going to bed. 	learning and applying knowledge
That's fantastic, do you usually use any new methods or strategies to complete your puzzles? 	learning and applying knowledge
Well, I do read a study book on puzzles at least once a day and use its various strategies to complete Benders—a harder kind daily with three metaphased spinal patchworks.	learning and applying knowledge
Interesting! So then that appears to help	none
--------------------	--------------------
How are you feeling today?	communication
I'm feeling okay today. How about you?	communication
I'm doing well. Hey, I wanted to ask you, when do you enjoy learning the most?	learning and applying knowledge
Hmm, that's a tough one. Maybe when I'm hearing a story on the radio or when I'm reading the newspaper.	learning and applying knowledge
Oh, that's interesting. And when do you find it most helpful to apply knowledge?	learning and applying knowledge
Well, when I'm grocery shopping, I always use the budgeting skills I learned in school.	learning and applying knowledge
That's smart! How about problem-solving? When does that come into play in your daily life?	general tasks and demands
Sometimes when a drain is clogged, I try to remember some	general tasks and demands
--------------------	--------------------
How's your day been, life been treating you well?	interpersonal interactions and relationships
Not bad, not bad. 	interpersonal interactions and relationships
Well, actually I have a lovely news about dealing with technology! 	learning and applying knowledge
Really? What technology are do you mean? 	communication
You know, when thinking through examples will help with clarity of the concepts to seep in; also showing images when we look up certain terms on Google -  particularly newer definitionssignaling communication technologies featureworkup that being undertaken by my doctor friend group : 	learning and applying knowledge, communication
Films, museum exhibits, work exhibits, and internet browsers from our club zone are found bound mentally in access hour when wire game supply first comes when using links. Updating defaultsprotection common settings digitally connected tablet	none
--------------------	--------------------
How was your day, did you learn something new?	learning and applying knowledge
Yes, I tried to learn how to set up online banking through my computer. 	learning and applying knowledge
That's great! When did you start learning the new skill? 	communication
After watching an instructional video, I started learning how to dependent use the websites and organize my transactions later next week. 	learning and applying knowledge
How did it go, was it challenging or was straightforward to go through setting up accounting in your upper filing and evaluating partiton pantheon? 	communication
It seemed easy because the gentle person's direction made working intuitve because?...However after getting some days using this all-action-based experiential-learning module into operation did notice now how my bills' proportional balances change	none
--------------------	--------------------
So how have you been doing lately?	communication
Well, I have been keeping myself pretty busy during the day.	general tasks and demands
Interesting, could you tell me more about your daily routine?	communication
Sure, well I typically start by practicing some vocabulary exercises and writing exercises in the mornings. I find that it is an essential way for me to mingle some creative stimulationexploration with the ongoing knowledge-based stimulation.	learning and applying knowledge
That is fascinating. When did you start doing these exercises?	communication
It began about 8 months ago when I noticed that my brain felt post-emptied from performing activities of mostly physicality each day. So, I resolved to buckle-down with language studies which piqued my interest, ever since.	learning and applying knowledge
--------------------	--------------------
Hi there! How are you feeling today?	communication
Oh, I'm doing alright, I suppose. 	communication
That's good to hear. Can I ask you, howwhen do you usually learn new things?	learning and applying knowledge
Well, I do read a lot every morning, the most exciting did teach me new answers.	learning and applying knowledge
That's great! What do you enjoy reading?	communication
I like to read the news articles, and everything about astronomy.	learning and applying knowledge
Wow, that's really cool. Sounds like you've learned quite a bit from reading about astronomy! How about applying that knowledge - how do you envision yourself using your understanding of the heavens?	learning and applying knowledge
I often imagine all the wild places within, forces beyond our	none
--------------------	--------------------
How has your day been going so far? 	none
It's been going okay so far. 	none
Have you been working on anything or focusing on a project specifically? 	learning and applying knowledge
Yes, actually. I've been trying to teach myself how to crochet. 	learning and applying knowledge
That sounds like a great way to learn something new! How exactly have you been going about learning how to crochet? 	learning and applying knowledge
I watched a lot of how-to videos on YouTube and followed along step-by-step. 	learning and applying knowledge
Wow, do you find it hard to concentrate and learn from those videos, or is it easy for you? 	learning and applying knowledge
Sometimes I get a bit overwhelmed, but I always pause and take breaks as needed to really understand each	learning and applying knowledge
--------------------	--------------------
How’s everything with you, today?	communication
Oh, you know, the same old days that come and go. What do you want me to tout anyways?	communication
Just normal talk I guess, how was your day today?	communication
Nothing new today dear. Just worked out the Sunday puzzle while nearly taking a respite from my bird watching pastime.	learning and applying knowledge, general tasks and demands, domestic life areas
Hmm fair enough. Do you remember anything quirky about today?	communication
Well, let me think. Oh yes, tried a recipe requested by our Andrew last weekend for today, almost; utilizing mince peel-begging but really liked adoring decent ratio equilibrium towards ginger-prescriptions organic fusion, convinced myself meal approved pseudo by nephew outthaw rating status	learning and applying knowledge, domestic life areas
--------------------	--------------------
What did you do today, Marie?	none
Oh, not much. I woke up early and had breakfast.	self-care
Did you learn or do anything new today?	learning and applying knowledge
Well, I tried to learn how to use my new phone a little more. It’s always a struggle.	learning and applying knowledge
That's great. How did you find it?	communication
I found It a little challenging I don't seem to understand how to set-up email correctly.	learning and applying knowledge
Learning new technology can be difficult, do you frequently confront these kinds of technological learning curves or is it other issues too?.	learning and applying knowledge
Yes often, it seems the apps keep updates I forekced the sequence l need	learning and applying knowledge
--------------------	--------------------
How are you doing today?	communication
Oh, I have been feeling fine today.	communication
That's good to hear. Could you tell me more about what you are doing during the day on this weekend?	communication
Absolutely. I spent some time reading my favorite books and magazines.	learning and applying knowledge
When do you usually do this, during the daylight or nighttime?	communication
Usually, daytime. It's easier for me to stay focused during the day.	learning and applying knowledge
Is it a particular reason why reading during the daytime works?	communication
Yes, I feel much more alert and sharp in the morning and find it easier to absorb new information.	learning and applying knowledge
That's an excellent strategy to optimize your learning capabilities. Do you think this kind of reading makes	learning and applying knowledge
--------------------	--------------------
How was your day today?	communication
It was alright; just a bit tiring.	none
What did you do today?	communication
I just stayed at home and read some books.	domestic life areas
What types of books were you reading?	learning and applying knowledge
I was reading some historical fiction novels.	learning and applying knowledge
Interesting! When did you start enjoying reading?	interpersonal interactions and relationships
I've always enjoyed reading. Ever since I was a kid, I loved losing myself in books.	learning and applying knowledge
That's great! Have you learned anything new from reading these historical fiction novels?	learning and applying knowledge
Yes, I learn something new every time I read them. They're a good way for me to apply my knowledge about history.	learning and applying knowledge
When do you usually read?	none
--------------------	--------------------
Hey there, how have you been lately?	communication
Oh, hello, well, thank you for asking. I've been trying to keep myself busy.	communication
That sounds good, what type of activities fill up your daily routine?	communication
Well, I always try to learn something new every day by reading articles on the Internet or watching educational shows on the different platforms!	learning and applying knowledge
That's great, do you tend to apply the things you learned right away?	learning and applying knowledge
As a matter of fact, yes! I also make a daily word bank so I won't forget new interesting words and afterward make an example sentences of the words I learn. How about you? 	learning and applying knowledge
That is remarkable! for me, My day usually starts	none
--------------------	--------------------
How was your day, did you learn anything interesting today?	learning and applying knowledge
Yes, I stayed at a rehab centre for some therapies purposes such as writing reading and hand-eye coordination. 	learning and applying knowledge
Sounds great. How long have you been learning focusing or pursuing it during these therapies? 	learning and applying knowledge
I attend lessons three days a week for two and half hours continuously by strolling pieces of paper different rhythm or colours like whatever the target will narrow related to pitch color.	learning and applying knowledge
Very interesting. Have you also acquired any additional language thus pursuing therapies here? 	learning and applying knowledge
Not paying particular attention buy i believe i can hum edges or consistent approach like saying correctly anything hearing sometimes couldn't point starting handwriting loop ensure loop relying probably respond properly differentiate vertical then horizontal	learning and applying knowledge
--------------------	--------------------
How was your day?	communication
It was good except that I had a hard time understanding this week's newspaper.	learning and applying knowledge
When do usually find it difficult to understand the newspaper?	communication
Well, I have a hard time every time there is an article about insurance or taxes.	learning and applying knowledge
Do you confidently read through a document before concerning yourself with thoroughly assimilating it?	communication
Actually, I usually just read fast to get through all the articles and seldom understand them.	learning and applying knowledge
Have you considered supplementing this way of reading, otherwise simply tearing mail and hitting dismiss straight apparent medication notices without giving remaining thought into it be for another?	communication
To be frank.! I haven’t thought about consistently dedicating more time while giving	none
--------------------	--------------------
What did you do yesterday?	none
I worked on a puzzle in the morning.	learning and applying knowledge
That's great, how did you feel afterwards?	none
Accomplished, but it took a while to complete.	none
Do you solve puzzles often?	none
Yes, but bills and writing a grocery list highlights my visual perception capability, that's why I need these puzzles much as good routine.	learning and applying knowledge, general tasks and demands
It's understandable to have good everyday stamina, how long does it generally take to do puzzles?	none
Sometimes all day. And if irritation persist sometimes that ranges subjective impairment session 2 may span14hours	none
That's certainly a long time. Have you noticed anything that would assist with getting better or faster at puzzles	learning and applying knowledge
--------------------	--------------------
Could you tell me a little bit about what you did today?	none
Yes, today I focused on trying to make bread for the first time.	learning and applying knowledge, general tasks and demands
Wow, that's great! When did you start thinking about making bread?	interpersonal interactions and relationships
Well, I have always been interested in homemade bread so yesterday I decided to read some baking recipes to try it out myself.	learning and applying knowledge
That sounds like a good beginning for learning. Did you find something challenging in the recipe while reading?	learning and applying knowledge
I had some trouble understanding the bread-making terminology. This made me skip dissecting recipe too fast. But then I substracted dough to adjust quantities and quietly start over.	learning and applying knowledge, general tasks and demands
It's good you applied what you learned to adjust your insufficient	learning and applying knowledge
--------------------	--------------------
Hi, how has your week been?	communication
Not too bad, just the usual stuff - trying to remember to take my morning medication and cooking my meals.	self-care, domestic life areas
I bet those things help you keep on a regular routine in terms of time management. Are you still able to perform some critical thinking skills exercises?	learning and applying knowledge
Yes, family comes over once a week, and we review current events together while snuggested taskforce panel[update on vaccination appeals to senior secretary Macdonald today]. Afterward, we chat about how problematic is particular news towards society sometimes makes shocking outcome where critical thinking needed.	interpersonal interactions and relationships, learning and applying knowledge
That's excellent to hear. Towards technology, are you using it at all?On occasions of interaction with responsibility such as some	communication
--------------------	--------------------
Hey there, how are you doing today?	communication
I'm doing well, thank you.	communication
That's great to hear. Can you tell me about some of the things that you've been doing recently that required you to apply knowledge?	learning and applying knowledge
Well I spend most of my morning times working on puzzles and number games.	learning and applying knowledge
Wow, that sounds like a good challenge! When do you start them?	communication
Usually after breakfast when I want my mind fit.	learning and applying knowledge
That's cool, what kinds of puzzles do you work on?	learning and applying knowledge
Lately I have been trying Cryptaritmess image puzzles: rearranging letters following an equation to get an arranged picture out of	learning and applying knowledge
--------------------	--------------------
How was your day today?	communication
Not bad dear, just taking it all one day at a time.	communication
Did you have any important appointments today that required a lot of thinking or problem solving?	learning and applying knowledge
Yes actually, I had a meeting with my financial adviser, that required both thinking and decision making.	learning and applying knowledge
Good for you for taking proactive steps regarding your finances! How confident do you feel now regarding handling your finances going forward?	learning and applying knowledge
I'm still trying to wrap my head around some of the suggestions she made, but I feel more confident now understanding what's available and what options to think about.	learning and applying knowledge
That's great! Were there any other events from today that involved applying your	none
--------------------	--------------------
So how was your day today?	communication
Well, I had some tackling situations.	general tasks and demands
What do you mean by tackling situations?	communication
Like I did some gardening where I had to figure out which plants require more or less water and how much of it should I use for gardening?	learning and applying knowledge, general tasks and demands
Oh, sounds quite troublesome. So, do you think your knowledge on environmental catering helped solving the situation?	communication
Of course. When you acquire learning on composting you have better comprehension on taking care for areas infested by bindweed, hence managing weeds properly.	learning and applying knowledge
Wow! You know much about conservation cleaning , waters mixtures, and soil maintena.ng skills.Were they useful implementing though?	learning and applying knowledge
Throughout time you f	none
--------------------	--------------------
So, how was your day today?	communication
It was okay, I had my morning coffee, read a few chapters of that new novel I started reading, and then checked my emails.	learning and applying knowledge, general tasks and demands
That sounds good. What time do you have your morning coffee usually?	communication
I usually have my first cup of coffee at around 8 am.	general tasks and demands
And what about checking your emails, when does that happen?	communication
Typically right after my coffee, I found that starting my working day with checking my Inbox always works great for me.	general tasks and demands
How long did you spend reading the novel earlier?	learning and applying knowledge
I read about 15 – 20 minutes this morning.	learning and applying knowledge
That's great P! Do you think that by maintaining	none
--------------------	--------------------
So, how was your day today? 	communication
Oh where to begin, as an adage in our generation goes I try to see day as much less focused of amount success 	learning and applying knowledge
That's true, though you know sometimes affirmations help...Are you still rehearsing that translation from Italian we provided ?	communication
Quite much, takes up from remembering and googling nugtones of grammar so now that sticks fear but raises daring nonetheless as Montaigne cautions feverial practice entails limiting 	learning and applying knowledge
Fey good! Nothing mastered outright absence drive specially novelty-- how do beginning other things start? Say language, rendering per barner so taxing	learning and applying knowledge
. 	none
well around sometime near past noon. Adopt blind text lessons attempting annotation chron	learning and applying knowledge
--------------------	--------------------
What did you do yesterday?	none
I went to the store in the morning and then I came home to do some gardening. 	domestic life areas, mobility
Did you have any trouble when you went out shopping? 	none
No, I remembered my list and focused on each item relating cough drops and liver It was pretty straightforward.	learning and applying knowledge, communication
That's good to hear. Did you calculate the price of your purchase in the store? 	learning and applying knowledge, communication
Yeah, I calculated on my paper and rechecked in a sec while walking towards the entrance. 	learning and applying knowledge, communication, mobility
Great, You’re getting pretty adept finding errors in your assessments quickly. Made cruising the store earlier today aide less error. 	learning and applying knowledge, communication
God protracts abilities of specitious..just trying adopt logic	none
--------------------	--------------------
