utterances	labels
So, how was your day today?	none
It was a good day. I spent time learning how to do embroidery at home.	learning and applying knowledge (embroidery)
Really, that sounds interesting! When do you usually take time to do embroidery?	interpersonal interactions and relationships
Whenever I have a free hour or so during the day, I like to do embroidery. 	general tasks and demands
How do you feel when you are doing embroidery at home?	none
I feel relaxed and good because I know I am learning a new skill.	none
That's great! Can you share a little bit more about what all is involved in the embroidery process?	learning and applying knowledge (embroidery)
Well, you have to pay attention to pattern and different colour threads for each section. It's actually fairly easy but it requires patience	learning and applying knowledge (embroidery)
--------------------	--------------------
What did you do today?	general tasks and demands
I stayed at home and worked on cross-stitching a couple of hours.	learning and applying knowledge
Wow, that's cool! When did you learn how to cross-stitch?	communication
When I was young, my mother taught me how to cross-stitch. She was very interested in arts and crafts. 	learning and applying knowledge
It's nice that you can continue pursuing your passion at home. 	interpersonal interactions and relationships
Absolutely, I actually make a lot of embroidered table cloths, tabletoppers, runners, pillow cases and many more decorative items embroidered with beautiful traditional designs.	learning and applying knowledge
That's very talented. Does crafting help you with your daily functioning?	major life areas
Yes, these activities require a lot	none
--------------------	--------------------
What have you been doing today?	general tasks and demands
Today, I was working on my crafting skills.	learning and applying knowledge
Oh, what did you make? How do you learn to craft?	communication
I made a set of Christmas decorations, it is coming soon! But I usually learn by watching tutorials online.	learning and applying knowledge
That's nice. Have you been keeping up with your lessons?	general tasks and demands
Definitely, every Wednesday I attend a quilting class. It's a great way for me to practice hand movements and gain entrepreneurial skills making them yourself for you to possibly sell them afterwards.	learning and applying knowledge, general tasks and demands, major life areas
Yeah very smart to developing new supportive instruments for a better management. And did the classes end ere before the pandemic ongoing?	communication
Indeed the VHS facilities in the	none
--------------------	--------------------
Hi there! How was your day yesterday?	communication
It was quite busy. I spent most of my day learning crafting.	learning and applying knowledge (crafting)
That sounds interesting. What kind of crafts do you like to make?	communication
I like to make quilts. I find it relaxing.	learning and applying knowledge (quilting)
How often do you work on your quilts?	none
Almost every day for at least an hour or two.	learning and applying knowledge (quilting)
That's great. Do you have any other learning or training activities that keep you busy?	none
Well, I also like to read educational books and articles, especially about art and history.	learning and applying knowledge (reading)
When do you usually find the time to read?	none
Usually in the afternoons. I try to read for an hour	learning and applying knowledge (reading)
--------------------	--------------------
How have you been spending your days lately? 	major life areas
Ever since my grandson quit visiting me weekly, it's slower but still manageable. 	interpersonal interactions and relationships
What do you do to counter loneliness? 	interpersonal interactions and relationships
I have been doing some cross stitching from my bookstore-couldn't-sell inventory to pass the time.	learning and applying knowledge
When do you usually do housework? 	domestic life areas
In make two categories. Cleaning and comprehensive work on Wednesday and small fittings with the ongoing sculpting task when sparks fly early in morning. 	domestic life areas
When do you prefer going to the market to shop? 	community, social and civic life
My children comes once every Ortem late Sunday to bring supplies.Maybe rare flea market during a forgettable second half-week.	community, social and civic life
--------------------	--------------------
So how was your day so far?	none
It's been quite alright. I woke up and make breakfast for myself this morning.	domestic life areas
That's great to hear. How do you usually make your breakfast?	domestic life areas
Usually some toasts with butter and milk tea. Plus, I setup my reading book while I eat.	domestic life areas, learning and applying knowledge
Good to know that you maintain your reading habit. Do you have any plan later on today?	none
Yes, I'm planning to go to the art center here in the neighborhood to learn some crafting techniques.	learning and applying knowledge, community, social and civic life
When do you usually go for it and how do you think it improves your overall functioning?	learning and applying knowledge, community, social and civic life
Usually twice a week. It definitely does	learning and applying knowledge
--------------------	--------------------
Do you engage in any daily activities that you find meaningful?	major life areas
Yes, I spend most of my mornings learning on my own practicing an ancient fortune-telling technique.	learning and applying knowledge
How often do you ordinarily perform this; as far as a typical timeframe is concerned?	none
Oh, a start manual holds instructions that initially--encompass shadow puppet making schooling, painting techniques using brush and not comb of course and musical lessons using a pawnplumer liren.and further steps I self-adjudged over time to adjust better caterly-solutions, this made in 324 narrow tents by Mao Qize all instructions chronic child-guard for hometown hand-letter postpeople's compilation early AD time sort functions up plainly broad 	learning and applying knowledge
--------------------	--------------------
How was your day, have you done something enjoyable today?	none
Yes, my granddaughter taught me how to knit this basic sweater. I tried to follow every step, putting the yarn through the loop so many times.	learning and applying knowledge
That's great to hear, Was it difficult for you to complete your task?	none
Yes, at first. Yet after she showed me every detail, it wasn't intense anymore so when we practiced with plain interlocking stitches it went smoothly.	learning and applying knowledge
When and how often do you knit at home after that?	none
When Helen had similar crafting stations on public American holiday after couple weeks practicing and I'm always knitting for holidays celebrations too so once-thrice a week raises immense my joy. 	domestic life areas
--------------------	--------------------
How has your daily routine been lately?	major life areas
Oh, it's been pretty much the same. I spend most of my time exploring new crafts at home.	learning and applying knowledge
That sounds interesting! What kind of crafting do you like to do?	interpersonal interactions and relationships
Mostly crocheting. I started learning it a few years ago and haven't lost interest in it since.	learning and applying knowledge
That's great, when do you usually do that during the day?	general tasks and demands
Mostly in the afternoon. Around 2 pm until 4-5 pm depending on how difficult the pattern is.	general tasks and demands
How long does it take you to start and complete a craft?	general tasks and demands
It depends. A simple mystery isn't continue, it could be a few minimum and a	none
--------------------	--------------------
So how was your day today?	none
Quite eventful, something different and surprising after carrying out machine exercising which is literally intense on its own.	learning and applying knowledge (machine exercising)
That sounds full on! How long does each exercise usually?	general tasks and demands (duration of exercise)
Actually a single exercise roundus around how my hand could remain clinching a working gadget.it takes around Hour or Half hours.	general tasks and demands (duration of exercise)
Do you still have time in the day to relax after the machine exercise then?	none
yaes,yes absolingly,As used half cycle on grounding blanket,litle revrunirty balancing by shoes and cooling lemount vield by chocolate aroma without quaff even alone.	self-care (relaxation techniques)
Wow.It really sounds like you're taking care of your health and doing	self-care (taking care of health)
--------------------	--------------------
Hi there! How are you doing today?	interpersonal interactions and relationships
I am doing great. How about you?	interpersonal interactions and relationships
Not bad, thanks. Can you tell me more about your daily life? What do you usually do during the day?	major life areas
Well, in the morning, I wake up, take a shower, and make breakfast for myself and my husband.	self-care, domestic life areas
Nice! Do you do anything else before work or does that pretty much fulfill your major life area events for the morning?	major life areas
Well, sometimes I will answer emails if I need to catch up on work stuff, but typically I leave that for after I drop he off at the daycare.	general tasks and demands
That makes sense. So you have a job that you go to, right	major life areas
--------------------	--------------------
What did you do yesterday, Mr. James? 	none
I attended my medical check-up in the morning and then followed up with an online job interview. 	general tasks and demands
That’s exciting. Can you tell me more about the job you’re applying for? Who’s the employer and what does the position entail? 	communication
The employer is a start-up that works remotely. I applied for a part-time role that involves financial analysis and managing basic accounts. 	learning and applying knowledge
And how do you relate these tasks to responsibilities you had before? 	learning and applying knowledge
I draw on my past familiarity of managing paperwork as well as engaging closely with clients. However, I tapered back my calculations previously at work and instead ensure a strict standard of marking submission aids	learning and applying knowledge
--------------------	--------------------
How are you today?	communication
All good. Thanks, how about you?	communication
I am fine. What have you been up to these days?	communication
Not anything unusual. Just went to the grocery store yesterday.	domestic life areas
Oh great! How did you feel about it?	communication
Well, I observed I hadn't been there for a couple of weeks, so I found it changing a bit.	learning and applying knowledge
So, do you find it easy to go grocery shopping or do everyday tasks nowadays?	general tasks and demands
Absolutely, not. For formal big supermarkets like the one I went to yesterday, mobility can pose a bit of a problem.	mobility
How about handling your household matters?	domestic life areas
Handling household matters previously was astonishing. However,	none
--------------------	--------------------
What have you been up to lately?”	none
“Not much, I’m just trying to stay occupied. Growing old isn’t as easy as they say it is…”	major life areas
“Well, what have you been doing for fun? Do you get out much these days?”	major life areas
“I’ve been trying to stay social by joining some assisted living center activities. They have them at the center every Monday and Thursday, so at least I have that to look forward to.”	community, social and civic life
“That’s great to hear! Other than social settings, how has your day-to-day been functioning? “	major life areas
“Behavior wise it's good” 	none
F; “That’s great to hear!”	interpersonal interactions and relationships
”As	none
--------------------	--------------------
What did you do yesterday, any activities at home?	domestic life areas
Yesterday I was cleaning and sweeping my place for me to feel more comfortable and spacious.	domestic life areas
That's great to hear. It's essential to keep your home clean and tidy. How about any other activities aside from cleaning the house?	domestic life areas
After the cleaning, I started baking cookies. My grandchildren will be visiting me today, and they love cookies, especially the chocolate chips one.	domestic life areas
It sounds delicious! When did you start learning how to bake?	learning and applying knowledge
As they say, learning is constant throughout our lives. At my age, I'm focusing on baking to continue keeping myself active.	learning and applying knowledge
That's a good point. Learning is a still-opening window in	learning and applying knowledge
--------------------	--------------------
What have you been up to lately? 	major life areas
Well, not much. Just spending most of the time at home.	domestic life areas
Do you need any help with anything?	none
Thank you for asking. Actually, I have been struggling with getting dressed as I recently injured my ankle very badly.	self-care
When did you hurt your ankle?	none
Few months back when I was doing some housework.	domestic life areas
Did you receive any care or treatment for your injury?	none
Yes. I was fortunate to see a great doctor and also spend few weeks in physical rehabilitation.	self-care
How has that affected your experiences overall?	major life areas
It has changed my life in some ways, for sure. Not nearly able to do all the things	none
--------------------	--------------------
How was your day, did anything interesting or challenging happen that may reflect your functioning in major life areas?	major life areas
Oh, today was a bit more exciting than usual. I went to my weekly volunteer work for community services, helping others through counseling and mentorship.	community, social and civic life
That's great to hear! Do you find volunteering fulfilling?	interpersonal interactions and relationships
Yes, I do. It never felt like additional work since it's ample positive emotional reward and contribute to my sense of social belonging.	interpersonal interactions and relationships
I am impressed! How often do you go? And would you like to join a collaborative program for attention to personal improvement outside of the volunteer sessions, for etching your corporate responsibilities?	none
Personally, I dedicate around 2 -4 hours weekly	community, social and civic life
--------------------	--------------------
Hi! What have you been up to lately?	interpersonal interactions and relationships
Just going about my usual day.	general tasks and demands
What are some of your typical activities?	none
Well, I usually do some light staffing work around the area early in the day. Later on, I tend to spend some leisure time with friends.	domestic life areas, leisure activities
That sounds like an engaging routine. About that staffing work, how did you attain such work?	learning and applying knowledge
One day, when giving flowers a park where a farmers market occurred weekly, Damian pulled up in his full size white truck and catered the weekly floating house events that I partied. Upon conversation, he let me know that his broadowrk opportunities could land me some shift turn up seemingly effective individuals with available schedules back	none
--------------------	--------------------
How's your day been, MrMs? Anything new?	interpersonal interactions and relationships
Well, I woke up early this morning and did all I had to at home so that I can report at work early tomorrow.	domestic life areas
That sounds like you work with a bit of a routine timing. But tell me, how did you land that job?	learning and applying knowledge
Oh, I graduated from university about five years ago and did some writing practice for a while, but it never really amounted to much. So I gritted my teeth and sent job interview mail out every pole To ask insight.	learning and applying knowledge
And how about the folks working around you, for lack of a better term, your working mates? Are you picky around them or are you just comfortable great	interpersonal interactions and relationships
--------------------	--------------------
So, how've you been lately?	interpersonal interactions and relationships
Oh, I've been keeping busy, trying to stay active with everything happening.	general tasks and demands
Can you tell me what kind of activities or projects are keeping you busy these days?	general tasks and demands
Well, actually, I'm really excited to be starting a volunteer position at the local shelter next week.	community, social and civic life
That's wonderful. How did you hear about that opportunity?	interpersonal interactions and relationships
My neighbor has been volunteering there for years and she was telling me how rewarding it is.	interpersonal interactions and relationships
And what sort of duties or tasks will you be responsible for?	general tasks and demands
I'm not sure of all the specifics yet, but the orientation paperwork mentioned helping with daily chores, taking the dogs for walks to poopsies	community, social and civic life
--------------------	--------------------
Hi there! How are you doing today?	communication
Oh, I'm doing alright. Just feeling a little tired.	communication
I see. Have you been up to something interesting lately?	communication
Well, I recently started volunteering at a local food bank.	community, social and civic life
That's great! When do you usually volunteer?	community, social and civic life
I volunteer every Monday morning.	community, social and civic life
And how long do you volunteer for during those mornings?	community, social and civic life
Usually for about three hours.	community, social and civic life
Have you noticed any changes in your functioning or daily life after starting to volunteer?	major life areas
Yes, I feel more energized throughout the day and have started to adapt better to changes in my schedule.	major life areas
Have you looked into other volunteering opportunities within other organizations?	community, social and civic life
--------------------	--------------------
I try to stay active during the day. 	general tasks and demands
That's good to hear. What sorts of activities do you perform each day? 	general tasks and demands
Cleaning the house and tending the garden usually keep me busy in the mornings. 	domestic life areas
That sounds like a lot of work!	none
Yes. And then in the afternoon I try to complete baking for my neighbors and then center tidy up stills aside some mart of my day, let alonen seeking job people speaking aboutn much lah. 	domestic life areas
Wow, you are very generous with the baking. Do you volunteer somewhere taking necessary precautions?	community, social and civic life
Not really because of some unavoidable circumstances, although till pandemic, I have worked under several bosses culminating in her teenage	none
--------------------	--------------------
Hi! Trichelle, What have you been up to these days? 	interpersonal interactions and relationships
Hi there, nothing specific – getting older, memory used to be better, workload has as decreased due to retirement	major life areas
How's your family getting along? 	interpersonal interactions and relationships
My granddaughter is doing so well in her internship - just wish her, nothing more should imply, just get paralyzed by feeling conCOMITANT trepidation or nostalgia round reflecting oneself this adds press and wastes youth time	interpersonal interactions and relationships
Is it good to hear, It's incredible to think how quickly we grow old and transition to a new phase of our lives-you mentioned yourself going into retirement-how did.That happen?	major life areas
Surely has Hitings adjustment been occurring in perceptions ability declines unlike	none
--------------------	--------------------
What have you been up to recently, how has your day been so far?	interpersonal interactions and relationships
Just went on a quick walk this morning, Feeling a little sore now though!	mobility
Well being active is always a good thing, do you feel like the exercise makes you function better in your daily activities?	general tasks and demands
Absolutely, Helps lose the happy gain! I also recently coordinated with a Freinds corner to help a nephew find an internship.	interpersonal interactions and relationships
That’s great to hear, when does the internship start, and what kind of work will be involved? 	interpersonal interactions and relationships
The intwrship starts next week. He requires the assistant in management jobs around the facility. It requires maintaining record mbjchatmahui guidelines., providing customer service and	general tasks and demands
--------------------	--------------------
Hi, how are you feeling today?	communication
Oh, I'm feeling just okay.	communication
How did you spend your day today?	none
I try to weave some baskets today.	learning and applying knowledge
Oh, do you weave baskets often?	communication
Yes, kinda everytime after Breakfast.	learning and applying knowledge
Do you teach anyone how to make baskets?	interpersonal interactions and relationships
Sure I taught my grabdaughter to da how To do knots.	learning and applying knowledge
That's nice. I could've dropped Ahmad for an intern in my office you two months ago. How did it go?	major life areas
Ah, energy-consuming. It's quite manipulative sometimes dealing with fancy database technology didtools!	learning and applying knowledge
That sounds befuddling. What sorts things from happening in inter to same	none
--------------------	--------------------
Hi, How are you today?	communication
I am good today . 	communication
That's great! So, how was your day yesterday?	communication
It was nice. I went installed a few plants and then did my exercise routine.	domestic life areas
That sounds like a pleasant day. Do you work today?	communication
No, I am retired.	major life areas
What do you like to engage in most now that you have retired?	major life areas
Well, I volunteer part of my time giving lessons to kids twice a week at the local library. 	community, social and civic life
That sounds great. How did you become interested in that?	community, social and civic life
Actually I have had some extra free time and I figured I should fill it up by benefiting other folks.	community, social and civic life
--------------------	--------------------
Hey, how have you been doing lately? 	interpersonal interactions and relationships
Oh, not too bad really. Just another day in my life. 	none
What have you been up to recently? 	interpersonal interactions and relationships
Well, my daughter has been visiting often from out of town, so we've been taking short getaways several times. 	domestic life areas
That sounds intensive! How does that fit with participating in work or activities?	general tasks and demands
We've been doing it on weekends – so it doesn't hit work am retired, Elder Church Group none being booked fortunately 	major life areas
Oh, so what other things do you keep yourself busy with these days apart from a sustainable summer routine?	major life areas
I just released back my trial gardening started planning without stress herbal s	none
--------------------	--------------------
Hi there, how has your day been? 	interpersonal interactions and relationships
Oh, my day has been uneventful, just like any of my regular days. 	major life areas
What do you mean by regular days - What are the activities that you usually do during your weekdays? 	learning and applying knowledge
Well, I wake up early, make breakfast, take out my dog, and devote a couple of hours to some lighter work. 	domestic life areas
Can you tell me more about your work? Do you work in an organization? 	major life areas
No, I had retired a few years back. But every week I volunteer at a non-profit nearby space,it helps me keep adaptive to the works, patterns.	community, social and civic life
That's nice to keep being productive almost	none
--------------------	--------------------
How are you doing today? What did you do recently?	communication
Oh, I'm fine. I went out yesterday to get some groceries...	domestic life areas
That's good! I remember you talking about wanting to volunteer at the community center. Did you get a chance to do that?	interpersonal interactions and relationships
Actually, yes! I started volunteering a few days ago reading books to the children. I go every Tuesday and Thursday at 3 pm.	community, social and civic life
Wow that's great! It's good to be active in the community. When do you start your physical therapy this week?	community, social and civic life
I have a physical therapy appointment rigtvt at 1 pm tmere is pain nlcer my shouldwr. I'm confident	none
--------------------	--------------------
How was your day today?	communication
It was okay, just spent the day doing some volunteer work at the local soup kitchen.	community, social and civic life
That's awesome that you volunteer, when do you usually do this?	interpersonal interactions and relationships
Every Tuesday and Thursday mornings.	community, social and civic life
That's really great to hear! You also mentioned that you had left your job recently. When did that happen?	major life areas
Yes, I retired about three months ago. So now, I just have been spending time at home and attending some social events with my friends.	major life areas
I see, what do you usually do at home?	domestic life areas
Aside from catching up with my readings, I also enjoy gardening a lot. I do a lot of backyard gardening just good for its bonus	domestic life areas
--------------------	--------------------
